#Each output line corresponds to one molecule and has the following style: CellID	UMI	Barcode
# dash (-) = barcode base outside of read, 0 = deletion in barcode sequence (position unknown)
AAACCTGTCAACACCA-1	TCACGTTTGT	------------------------------
AAAGATGAGAGGTACC-1	TTGTCGCGTC	------------------------------
AAAGATGAGAGGTACC-1	GTTGACCTGA	TGTCAATCGTTCGGTTGAGCAAGATC----
AAAGCAAGTCCAGTAT-1	CGGTAGGTTC	TGTCAATC----------------------
AAAGTAGCAGTCTTCC-1	TTGCTCGGGT	------------------------------
AAAGTAGTCGACCAGC-1	CCTTTTATAG	TGTCAATCG---------------------
AACACGTAGCTAAACA-1	ATGTCTTAGT	------------------------------
AACACGTAGCTAAACA-1	TACTTGATAA	------------------------------
AACCATGCAAACCCAT-1	ACACATCAAA	------------------------------
AACCATGCACATAACC-1	CCGTGGGCTC	TGTCAATCGTTCGGTTGAGCAAGA------
AACCATGTCAGCAACT-1	CCCAACCTGA	------------------------------
AACCGCGTCACCGGGT-1	CGAGGCTAAA	------------------------------
AACGTTGAGTTGCAGG-1	CAAGTTCGGT	------------------------------
AACGTTGTCTAAGCCA-1	GCCATTACAC	------------------------------
AACGTTGTCTAAGCCA-1	GGTGTGACAC	------------------------------
AACTCAGTCAACGCTA-1	CATAATATGT	------------------------------
AACTCTTGTTGAACTC-1	CCGGTATGGT	TGTCAATCGTTCGGTTGAGCAAGATCTTAG
AACTGGTAGGCCCGTT-1	CGTGTATTGT	TGTCAATCGTTCGGTTGAGCAAGATCTTAG
AAGACCTCAGCGATCC-1	CAATTTTTAC	TGTCAATC----------------------
AAGACCTTCTAACTGG-1	TTGCCCGCTA	TGTCAATC----------------------
AAGCCGCAGTACGTTC-1	GTTTGCTAGT	------------------------------
AAGGCAGGTGAGCGAT-1	TCAGGTTATG	------------------------------
AAGGCAGTCTTAACCT-1	TTCAAATCTC	TGTCAATCGTTCGGTTGAGC----------
AAGTCTGCAAGGGTCA-1	CTCAACCCAA	------------------------------
AAGTCTGCAGGATCGA-1	ACCATAACGC	------------------------------
AAGTCTGCATCCAACA-1	ATCGCTCCAA	TGTCAATCGTTCGGTTGAGCAAGATCTTAG
AAGTCTGGTCGTTGTA-1	CTTTCCCTAG	------------------------------
ACACCAATCTACCAGA-1	CGCTAGGCAG	TGTCAATCGTTCGGTTGAGCAAGATCTTAG
ACACCCTTCTGATTCT-1	GTCGTAGCCC	TGTCAATCGTTCGGTTGAGCAAGATCTTAG
ACACTGAAGGCTCTTA-1	TTACTCGCTA	------------------------------
ACAGCTAGTCAGAGGT-1	AATTCCCGTG	TGTCAATCGTTCGGTTGAGCAAGATCTTAG
ACAGCTAGTCAGAGGT-1	GGCTCCAATT	TGTCAATCGTTCGGTTGAGCAAGATCTTAG
ACAGCTATCCTGCTTG-1	TCTTTGGTAT	------------------------------
ACATACGAGTACGCGA-1	TTTTCGATCC	------------------------------
ACATACGGTGGTCCGT-1	CCCGCCGCTT	------------------------------
ACATCAGCAGTTCATG-1	TTAGTCTCAG	TGTCAATCGTTCGGTTGAGCAAGATCTTAG
ACATCAGGTTATCGGT-1	TTCTCCCTTG	TGTCAATCGTTCGGTTGAGCAAGATCTTAG
ACATGGTAGGAGTTGC-1	ATTCATTGGG	TGTCAATCGTTCGGTTGAGCAAGATCTTAG
ACATGGTCACAGCCCA-1	GTACTTCCAT	TGTCAATCGTTCGGTTGAGCAAGATCTTAG
ACATGGTCACCTGGTG-1	CATAGGTCCT	------------------------------
ACATGGTGTGGCAAAC-1	GCATGTGATA	TGTCAATCGTTCGGTTGAGCAAGATCTTAG
ACCAGTACACTTACGA-1	AATATTTGGT	TGTCAATCGTTCGGTTGAGCAAGATCTTAG
ACCAGTAGTACCGCTG-1	CTATTCGGGA	------------------------------
ACCGTAAGTAATCGTC-1	TATTCCGCCC	------------------------------
ACCGTAAGTAGCGCTC-1	ATCGAGTTTA	------------------------------
ACCTTTAGTGACGGTA-1	TGCTTTCTCG	------------------------------
ACGAGGAGTATAGTAG-1	GTCGCAAATG	------------------------------
ACGAGGAGTATAGTAG-1	CGCAGCTAAA	TGTCAATCGTTCGGTTGAGCAAGATCTTAG
ACGATACCACACTGCG-1	ACGTATCTTG	------------------------------
ACGATGTCAAATTGCC-1	GCAACGCTTG	------------------------------
ACGATGTGTCACACGC-1	ATTCTATCTT	------------------------------
ACGATGTGTCACACGC-1	TTGGGTGGTT	------------------------------
ACGATGTTCTTTACGT-1	AGCGTGCCCG	------------------------------
ACGCCAGCAGCTGCAC-1	AACACAGGCC	TGTCAATCGTTCGGTTGAGC----------
ACGCCAGCAGCTGCAC-1	ATTCTCGTTA	TGTCAATCGTTCGGTTGAGCAAGATCTTAG
ACGCCGAAGCTAACTC-1	CTTTTTCGTG	TGTCAATCGTTCGGTTGAGCAAGATCTTAG
ACGCCGATCGCCATAA-1	CGTCGTCTCA	TGTCAATCGTTCGGTTGAGCAAGATCTTAG
ACGGCCACACATGGGA-1	ATAGGTGGCC	TGTCAATCGTTCGGTTGAGCAAGATCTTAG
ACGGCCAGTGTAAGTA-1	TGAGATCCGA	------------------------------
ACGGGCTAGACTAGAT-1	TGATGGTGAC	------------------------------
ACGGGCTAGACTAGAT-1	GCAAGGGAGT	TGTCAATCGT--------------------
ACGGGCTTCCGCGGTA-1	AACACTGAGG	TGTCAA------------------------
ACGGGTCCATTAGCCA-1	TTATAACCGG	------------------------------
ACGGGTCTCACCGTAA-1	GGTCAAGGAC	------------------------------
ACGTCAAAGCTCCCAG-1	AGTCCTAATT	------------------------------
ACGTCAAAGCTCCCAG-1	GTATGTCAGG	------------------------------
ACGTCAAAGCTCCCAG-1	TGATTAGTAT	TGTCAATCGTTCGGTTGAGCAAGATCTTAG
ACGTCAATCTGCAAGT-1	ATCCGAATGG	------------------------------
ACTATCTCACAGTCGC-1	GGCCTTTAGC	TGTCAATCGTTCGGTTGAGCAAGATCTTAG
ACTATCTCACAGTCGC-1	GTGCTAAGCA	TGTCAATCGTTCGGTTGAGCAAGATCTTAG
ACTGAACAGAGATGAG-1	TATTAGGGCT	------------------------------
ACTGAACAGAGATGAG-1	TTTTTTACGT	------------------------------
ACTGAACAGAGATGAG-1	GCCTGCGATA	TGTCAATCGTTCGGTTGAGC----------
ACTGAGTCACCCTATC-1	GTACCGCCAG	------------------------------
ACTGAGTTCCGCGCAA-1	TTCCCTATGA	------------------------------
ACTGAGTTCCGTTGCT-1	CTTATGGATG	------------------------------
ACTGAGTTCCGTTGCT-1	GTTGCGGTGG	TGTCAATCGTTCGGTTGAGCAAGATCTTAG
ACTGAGTTCCGTTGCT-1	TATCTAGAGA	TGTCAATCGTTCGGTTGAGCAAGATCTTAG
ACTGATGGTTCCATGA-1	CAACCTGTAC	TGTAAATCGTTCGGTTGAGCAAGATCTTAG
ACTGATGGTTCCATGA-1	TCGCCTTAGC	TGTCA-------------------------
ACTGCTCTCGAATCCA-1	GGGTGAACAC	------------------------------
ACTGCTCTCTGAGGGA-1	CGCGTGCTTC	TGTCAATCGTTCGGTTGAGCAAGATCTTAG
ACTGTCCTCGGTTAAC-1	TCCTGAGTTA	------------------------------
ACTGTCCTCGGTTAAC-1	TGTCTGTGGC	TGTCAATC----------------------
ACTTGTTAGCGTGTCC-1	GCCTTCTGCT	------------------------------
ACTTGTTAGCGTGTCC-1	CAATGTGATC	TGTCAATCGTTCGGTTGAGCAAGATCTTAG
ACTTGTTCAATAACGA-1	CGGTGTAGAC	TGTCAATCGTTCGGTTGAGCAAGATCTTAG
ACTTGTTGTACGACCC-1	CACGCCTTTT	TGTCAATCGTTCGGT---------------
ACTTTCAGTAATCGTC-1	TTTGTTACTA	TGTCAATCGTTCGGTTGAGCAAGATCTTAG
ACTTTCAGTGAAATCA-1	AGACCAGAAT	TGTCAATCGTTCGGTTGAGCAAGATCTTAG
AGACGTTGTAAGTGGC-1	TGTCGTCCTC	TGTCAAT-----------------------
AGACGTTGTAAGTGGC-1	GCCTTTATAC	TGTCAATCGTTCGGTTGAGCAAGATCTTAG
AGAGCGAGTTCCATGA-1	CCAGGCGACC	------------------------------
AGAGCTTTCAAAGTAG-1	TTCTTCTGAG	------------------------------
AGAGCTTTCGGCGCTA-1	TATCTGTACG	TGTCAATCGTTCGGTTGAGCAAGATCTTAG
AGAGCTTTCGTCGTTC-1	TAAGCTGCTT	------------------------------
AGAGTGGAGCACCGTC-1	CTACTCAACA	------------------------------
AGAGTGGAGCACCGTC-1	TAAACTGCTT	------------------------------
AGAGTGGAGGTAAACT-1	AATAAGAGAC	------------------------------
AGAGTGGCATGTAGTC-1	TTGTTTAATA	TGTCAATCGTTCGGTTGAGCAAGATCTTAG
AGATCTGGTCGCCATG-1	ATTGTTAGTA	TGTCAATCG---------------------
AGCAGCCAGGCGATAC-1	ATACTGTGTA	TGTCAATCGTTCGGTTGAGCAAGATCTTAG
AGCAGCCGTAAACACA-1	TTATTCGATA	GGTCTCCCTATACCAACAGTATCGTCTCAA
AGCAGCCTCATAACCG-1	ATAAGATCCT	TGTCAATCGTTCGGTTGAGCAAGATCTTAG
AGCATACAGCTGAAAT-1	CCGACGCATA	TGTCAATCGTT-------------------
AGCATACGTCATACTG-1	TAACAGGCTT	GGTCT-------------------------
AGCATACGTCATACTG-1	ACTGGCAGGC	GGTCTCCCTATACCAACAGTATCGTCTCAA
AGCCTAAGTCGAAAGC-1	CATAATTATG	TGTCAATCGTTCGGTTGAGCAAGATCTTAG
AGCGGTCTCATGTGGT-1	CCCGCATGGG	TGTCAATCGTTCGGTTGAGCAAGATCTTAG
AGCGTCGAGTGGTAGC-1	TGCGTCTGAC	TGTCAATCGTTCGGTTGAGCAAGATCTTAG
AGCGTCGCAAGGTGTG-1	ACGCGAGCAA	------------------------------
AGCGTCGGTACAGTTC-1	ATAGAGGCCT	------------------------------
AGCTCCTGTAATCGTC-1	TGTTACTTCT	TGTCAATCGTTCGGTTGAGCAAGATCTTAG
AGCTCCTGTCGAACAG-1	CATATAGGTT	TGTCAATCGTTCGGTTGAGCAAGATCTTAG
AGCTTGAAGTGGTAGC-1	CTGACATGAT	TGTCAATCGTTCGGTTGAGCAAGATCTTAG
AGCTTGACACGTAAGG-1	AGGGACTCGT	TGTCAATCGTTCGGTTGAGCAAGATCTTAG
AGCTTGACAGTAAGAT-1	CCCACAACGT	------------------------------
AGCTTGAGTTGATTCG-1	AGGCCTTTCA	------------------------------
AGCTTGATCAAAGACA-1	GTTTTAGCGT	------------------------------
AGCTTGATCCAAGTAC-1	TCGTCAAAGG	------------------------------
AGGCCGTGTTCATGGT-1	GTTTCTTGTT	TGTCAATCGTTCGGTTGAGCAAGATCTTAG
AGGGAGTTCCACGAAT-1	CACAGTTCCA	------------------------------
AGGGTGAGTAGAGGAA-1	CGGCGGTCTG	TGTCAATCGTTCGGTTGAGCAAGATCTTA-
AGGGTGAGTGGCTCCA-1	ACATAACTAG	------------------------------
AGGTCCGAGACTTGAA-1	CTACGTACCC	TGTCAATCGTTCGGTTGAGCAAGATCTTAG
AGTAGTCCAAGCGATG-1	CCTTAGGCTT	------------------------------
AGTGAGGCAGAGCCAA-1	TATTGAGAAA	------------------------------
AGTGGGAGTTAAGAAC-1	CAGGAACTAC	TGTCAATCGTTCGGTTGAGCAAGATCTTAG
AGTTGGTCAGGAATGC-1	CTATGTCAAT	TGTCAATCGTTCGGTTGAGCAAGATCTTAG
ATAACGCCAGTGACAG-1	CCATCTGGGC	TGTCAATCGTTCGGTTGAGCAAG-------
ATAACGCTCAGTTGAC-1	ATTACTATTT	------------------------------
ATAAGAGTCTGGTGTA-1	AAGCTGGTCA	TGTCAATCGTTCGGTTGAGCAAGATCTTAG
ATAGACCCATAAAGGT-1	GCTTGGCGCA	------------------------------
ATCACGAGTGATGTCT-1	GGTCCCTTGT	TGTCAATCGTTCGGTTGAGCAAGATCTTAG
ATCACGATCACTGGGC-1	TTTACTTGGA	TGTCAATC----------------------
ATCACGATCACTGGGC-1	CTTGATGAAA	TGTCAATCGTTCGGTTGAGCAAGATCTT--
ATCATCTTCTTAACCT-1	TCCACCATAA	------------------------------
ATCCACCCACTTAACG-1	CAATTGGCTG	------------------------------
ATCCGAAAGTATGACA-1	CAGCTCTAGT	------------------------------
ATCCGAACATCTCGCT-1	TCATGTAAGG	TGTCAATCGTTCGGTTGAGCAAGATCTTAG
ATCGAGTAGTAACCCT-1	TGGCTTGGCC	TGTCAATCGTTCGGTTGAGCAAGATCTTAG
ATCTACTTCCTATGTT-1	GAGGACTTGG	TGTCAATCGTTCGGTTG-------------
ATGAGGGCAGTTCATG-1	AAGCTATACT	------------------------------
ATGCGATAGTGTCTCA-1	CAGTTTGTGG	TGTCAATCGTTCGGTTGAGCAAGATCTTAG
ATGCGATTCCGAGCCA-1	TGCCGACATT	------------------------------
ATGCGATTCGGCGGTT-1	CATTTACTCG	TGTCAATCGTTCGGTTGAGCAAGATCTTAG
ATGGGAGCACAGCGTC-1	TAGGTGAGAG	TGTCAA------------------------
ATGGGAGTCGTTGCCT-1	TCTCTATATG	------------------------------
ATGGGAGTCGTTGCCT-1	TCCACATGCA	TGTCAATCGTTCGGTTGAG-----------
ATGGGAGTCGTTGCCT-1	TTTCTCCCTC	TGTCAATCGTTCGGTTGAGCAAGATCTTAG
ATGTGTGCAGTGGAGT-1	CCAAGTTCTT	TGTCAATCGTTCGGTTGAGCAAGATC----
ATGTGTGTCCCATTAT-1	TCATCGTGAT	TGTCAATCGTTCGGTTGAGCAAGATCTTAG
ATTATCCGTAAAGTCA-1	CATCCTGGTC	------------------------------
ATTATCCTCTTTACGT-1	AATGCACCCC	TGTCAATCGTTCGGTTGAGCAAGATCTTAG
ATTCTACAGCAGCCTC-1	CGTTCAATCT	TGTCAATCGTTCGGTTGAGCAAGATCTTAG
ATTCTACTCCTTTCGG-1	CAACAACATC	------------------------------
ATTCTACTCTTGAGGT-1	GATTTGCCCG	------------------------------
ATTGGACAGCGTAATA-1	AGAGAAAGTA	------------------------------
ATTGGACGTACCGTTA-1	GTATGTCATT	TGTCAATCGTTCGGTTGAGCAAGATCTTAG
ATTGGTGAGCGGATCA-1	TTAACGCCTG	TGTCAATCGTTCGGTTGAGCAAGATCTTAG
ATTGGTGAGCGTAGTG-1	TATCTTCCGT	------------------------------
ATTGGTGAGGGCTTGA-1	TGGCGCATTT	------------------------------
ATTTCTGTCTACTATC-1	ACAAGAATCA	TGTC--------------------------
CAACCTCGTTCATGGT-1	TATAAGGTGT	TGTCAATCGTTCGGTTGAGCAAGATCTTAG
CAACCTCTCAGTCCCT-1	CACTAATCGT	TGTCAATCGTTCGGTTGAGCAAGATCTTAG
CAACTAGCAAACGTGG-1	TCTCCGGTGT	------------------------------
CAACTAGCATGTCCTC-1	GTCATTGAAC	------------------------------
CAACTAGGTCTAGGTT-1	GTGATCTGTT	------------------------------
CAAGAAACACTTCTGC-1	CTTGCAACCC	------------------------------
CAAGATCGTCTAAACC-1	CTACCTTAGA	TGTCAATCGTTCGGTTGAGCAAGATCTTAG
CACAAACCAAGCGCTC-1	CACCTTACAT	------------------------------
CACACAAAGCCACGCT-1	ATAGCGTCCC	------------------------------
CACACAACACATAACC-1	TTTCTACTTA	------------------------------
CACACAAGTCTGATCA-1	AACTTCCTAC	------------------------------
CACACAAGTCTGATCA-1	TCACAGCGGT	TGTCAATCGTTCGGTTGAGCAAGATCTTAG
CACACAAGTTGCGTTA-1	TGATTTGAAG	TGTCAATCGTTCGGTTGAGCAAGATCTTAG
CACACCTCATTGGCGC-1	ATAAGGGCAT	------------------------------
CACACCTCATTGGCGC-1	TCTACAGACT	TGTCAATCGTTCGGTTGAGCAAGATCTTAG
CACACTCAGATTACCC-1	AGCACATCCA	------------------------------
CACACTCAGATTACCC-1	CCTGATTAAG	TGTCAATCGTTCGGTTGAGCAAGATCTTAG
CACACTCAGATTACCC-1	GGTGCACCAG	TGTCAATCGTTCGGTTGAGCAAGATCTTAG
CACAGTACAAGTCATC-1	CCCCAGTAAT	------------------------------
CACATAGTCCATGAAC-1	CTCTCACGAA	------------------------------
CACATTTCATTACCTT-1	GATTTCTGTA	------------------------------
CACATTTTCCGCGTTT-1	AAACGGTTCG	------------------------------
CACCAGGGTGCCTTGG-1	TGGTGAGGTA	TGTCAATCGTTCGGTTGAGCAAGATCTTAG
CACCTTGAGCTACCTA-1	GAAATTTTGG	TGTCAATCGTTCGGTTGAGCAAGATCTTAG
CACTCCAAGAGATGAG-1	GTCCATAGGA	------------------------------
CAGAATCAGTGCCATT-1	TCTCTATTAG	TGTCAATCGTTCGGTTGAGCAAGATCTTAG
CAGAATCCACAAGCCC-1	ATTCAGTAAT	TGTCAATC----------------------
CAGCAGCTCGGTGTTA-1	TCGGACATCA	------------------------------
CAGCCGAAGTCACGCC-1	ATTTTCCTTT	TGTCAATCGTTCGGTTGAGC----------
CAGCCGAGTAGCTCCG-1	ACCTCCGACT	TGTCAATCGTTCGGTTGAGCAAGA------
CAGCTAAAGGGCTTGA-1	ATTAGGAGGG	------------------------------
CAGCTAATCTTATCTG-1	CCACACACTT	TGT---------------------------
CAGCTGGAGTATTGGA-1	TAAACGCTTC	------------------------------
CAGCTGGTCTATCGCC-1	CGGTTTGTTT	TGTCAATCGTTCGGTTGAGCAAGATCTTAG
CAGTCCTGTTGCGTTA-1	AGGTATAGGT	TGTCAATCGTTCGGTTGAGCAAGATCTTAG
CATATGGCAGATCGGA-1	CGCATTCACT	------------------------------
CATCAAGTCAGTCAGT-1	CACGGATAGA	TGTCAATCGTTCGGTTGAGCAAGATCTTAG
CATCAGACAGCTCGCA-1	ATCAGCATAA	TGTCAATCGTTCGGTTGAGCAAGATCTTAG
CATCAGAGTTATCACG-1	CGCATGCGCT	------------------------------
CATCGAATCATATCGG-1	TGCCGACTGT	TGTCAATC----------------------
CATCGAATCATATCGG-1	GCTCCTGTGT	TGTCAATCGTTCGGTTGAGCAAGATCTTAG
CATGACAAGTGAAGAG-1	GTATTCAATG	------------------------------
CATGACAAGTGAAGAG-1	TGGAATCTGA	TGTCAATCGTTCGGTTGAGCAAGATCTT--
CATGCCTGTCATACTG-1	GGCAGAGTCG	------------------------------
CATGCCTGTCATACTG-1	TTTATTATCG	TGTCAATCGTTCGGTTGAGCAAGATCTTAG
CATTCGCAGGCGATAC-1	CTCGCTAGGC	TGTCAATCGTTCGGTTGAGCAAGATCTTAG
CCAATCCCAAATACAG-1	ACTTAATATT	TGTCAATCGTTCGGTTGAGCAAGATCTTAG
CCAATCCTCTCCCTGA-1	CCCCCTGGTT	TGTCAATCGTTCGGTTGAGCAAGATCTTAG
CCACCTACATGTAAGA-1	GAGTAGGATT	TGTCAATCGTTCGGTTGAGCAAGATCTTAG
CCACGGAAGTTGAGAT-1	TTTGACTATT	TGTCAATCGTTCGGTTGAGCAAGATCTTAG
CCAGCGACACGCGAAA-1	ACTAGCCGTC	TGTCAATCGTTCGGTTGA------------
CCATTCGAGTGAAGAG-1	GAGACATTAA	------------------------------
CCATTCGCATCCCACT-1	TATGTGAGTA	------------------------------
CCCAATCAGTCTCGGC-1	TGGGTCTTTC	------------------------------
CCCAATCCACACATGT-1	AGCATGACAG	------------------------------
CCCATACAGCTCCTCT-1	CTCTAGCACA	TGTCAATCGTTCGGTTGAGCAAGATCTTAG
CCGGGATAGTACACCT-1	TGCACCTTTA	TGTCAATCGTTCGGTTGAGCAAGATCTTAG
CCGGGATAGTACACCT-1	TTTTACCTGC	TGTCAATCGTTCGGTTGAGCAAGATCTTAG
CCGGTAGAGACACTAA-1	TGCTTGATGG	------------------------------
CCGGTAGAGACACTAA-1	AATACGTCTC	TGTCAATCGTTCGGTTGAGCAAGATCTTAG
CCGTGGAAGCTGCCCA-1	ATAGATCTTA	------------------------------
CCGTGGAGTTATGTGC-1	CCCTTCAGGA	TGTCAATCGTTCGGTTGAGCAAGATCTTAG
CCGTTCAGTACTTCTT-1	AACTCCGGCT	TGT---------------------------
CCTACACAGCTAGGCA-1	CACATCCCTA	GGTCTCCCTATACCAACAGTATCGTCTCAA
CCTACACCATATACGC-1	CGCACAATTT	TGTCAATCGTTCGGTTGAGCAAGATCTTAG
CCTACACTCACAAACC-1	TTTATAAATT	TGTCAATCGTTCGGTTGAGCAAGATCTTAG
CCTACACTCCTAGAAC-1	AAAGGGCAGT	------------------------------
CCTACCATCTGCCCTA-1	ACCGCTTCTT	------------------------------
CCTCTGAGTCCGACGT-1	AATAAAGCAA	TGTCAATCGTTC------------------
CCTTCCCGTTCGTCTC-1	ACTCTAGGTT	------------------------------
CCTTCCCGTTCGTCTC-1	GATAAACTAA	TGTCAATCGTTCGGTTGAGCAAGATCTTAG
CCTTCGAAGGGATCTG-1	GACTTTTAGA	TGTCAATCGTTCGGTTGAGCAAGATCTTAG
CCTTCGACACAACTGT-1	CAGTCTTCTG	TGTCAATCGTTCGGTTGAGCAAGATCTTAG
CCTTCGACACCTATCC-1	TTACCATTGC	------------------------------
CCTTCGAGTAACGACG-1	ATTCAGCTTT	------------------------------
CCTTTCTGTGTATGGG-1	GTATCCTTTG	TGTCAATCGTTCGGTTGAGCAAGATCTTAG
CGAATGTTCTCTTATG-1	ACCAGCCAGG	TGTCAATCGTTCGGTTGAGCAAGATCTTAG
CGACCTTCACAGGCCT-1	GTTAACGTTT	TGTCAATCGTTCGGTTGAGCAAGATCTTAG
CGACCTTCATGTCGAT-1	ACGTTTAATC	------------------------------
CGACCTTGTTCACGGC-1	TCGTATTCAC	TGTCAATCGTTCGGTTGAGCAAGATCTTAG
CGAGAAGCATTGCGGC-1	AAATTTGTAT	TGTCAATCGTTCGGTTGAGCAAGATCTTAG
CGAGCACGTGACTCAT-1	CGTTTCAGTA	TGTCAATCGTTCGGTTGAGCAAGATCTTAG
CGAGCACTCAAACCAC-1	CATCATCTAT	------------------------------
CGAGCCAAGACTACAA-1	ACTTCGGTTA	------------------------------
CGATCGGCAGACGCCT-1	CTACGCATCT	------------------------------
CGATCGGCAGCGTCCA-1	TAAATGCATC	TGTCAATCGTTCGGTTGAGCAAGATCTTAG
CGATGGCAGCACAGGT-1	CTAGTGAACA	------------------------------
CGATGGCAGCACAGGT-1	TCTTCCTAAG	TGTCAATCGTTCGGTTGAGCAAGATCTTAG
CGATGGCCAGCCTTGG-1	AAGCCGATCC	------------------------------
CGATGGCTCTGTGCAA-1	TTAGGCCAAT	TGTCAATCGTTCG-----------------
CGATGGCTCTGTGCAA-1	TTAATACGTA	TGTCAATCGTTCGGTTGA------------
CGATGTAAGCGTCAAG-1	TTAAAGGGTT	TGTCAATCGTTCGGTTGAGCAAGATCTTAG
CGATGTACATGCTAGT-1	GATAAGACGA	------------------------------
CGATTGATCACGCATA-1	AGTATGGCTT	------------------------------
CGCGGTAAGAGAACAG-1	CTTTTCTGCG	------------------------------
CGCGGTACATACTCTT-1	CTTTTTCATT	------------------------------
CGCGTTTGTGTCTGAT-1	TTCATATTGG	------------------------------
CGCGTTTGTGTCTGAT-1	CGGTCTATAC	TGTCAATCGTTCGGTTGAGCAAGATCTTAG
CGCTATCAGACTAGGC-1	GGTTGTACAA	------------------------------
CGCTATCAGACTAGGC-1	AAAATCCTTC	TGTCAAT-----------------------
CGCTATCCAGCTCCGA-1	ACACGTCTAT	------------------------------
CGCTATCCAGCTCCGA-1	CCTTGGTCAA	TGTCAATCGTTCGGTTGAGCAAGATCTTAG
CGCTGGAAGCTCCTCT-1	GCTTCGCTGC	------------------------------
CGCTTCAAGGTCATCT-1	AAAATGTAGG	------------------------------
CGCTTCAAGGTCATCT-1	TCCTCAATGG	TGTCAATCGTTCGGTTGAGCAAGATCTTAG
CGCTTCATCAGTCCCT-1	GATTATGTAT	TGTCAATCGTTCGGTTGAGCAAGATCTTAG
CGGACACAGCGCTTAT-1	CTTGCAGTTC	TGTCAATCGTTCGGTTGAGCAAGATCTTAG
CGGACACCAGGTTTCA-1	GTATCTAAAC	------------------------------
CGGACACTCCTTCAAT-1	CTTAATCCGC	TGTCAATCGTTCGGTTGAGCAAGATCTTAG
CGGACGTCAATGAAAC-1	TTTAAATTGC	TGTCAATCGTTCGGTTGAGCAAGATCTTAG
CGGACTGTCTTTAGTC-1	TTTTTTACTG	TGTCAATCGTTCGGTT--------------
CGGACTGTCTTTAGTC-1	TGTCGAATCA	TGTCAATCGTTCGGTTGAGCAAGATCTTAG
CGGAGCTAGAGCCTAG-1	AAATATTCGG	TGTCAATCGTTCGGTTGAGCAAGATCTTAG
CGGAGCTAGTTAAGTG-1	TGTCTAATCC	------------------------------
CGGCTAGCAATGACCT-1	AACAGTATTT	------------------------------
CGGCTAGCAATGACCT-1	TGTTAGTATG	------------------------------
CGGCTAGTCGTCGTTC-1	TCTGGCCGTA	------------------------------
CGGGTCATCAACTCTT-1	GACGGACATC	TGTCAATCGTTCGGTTGAGCAAGATCTTAG
CGTCACTCACGTTGGC-1	GCATTAATTT	TGTCAATC----------------------
CGTCAGGGTCAAAGCG-1	ATATTCCCCG	------------------------------
CGTCAGGTCCAAGCCG-1	ACGTCGGGCC	TGTCAATCGTTCGGTTGAGCAAGATCTTAG
CGTCCATCACGGATAG-1	ACAGTCGGCT	TGTCAATCGTTCGGTTGAGCAAGATCTTAG
CGTCTACGTCGCGAAA-1	TGCCATTTCA	------------------------------
CGTCTACGTCGCGAAA-1	GCCGTAACTT	TGTCAATCGTTCGGTTGAGCAAGATCTTAG
CGTCTACGTCGCGAAA-1	GTTGTTGATC	TGTCAATCGTTCGGTTGAGCAAGATCTTAG
CGTCTACGTCGCGAAA-1	TGGCTAGGTC	TGTCAATCGTTCGGTTGAGCAAGATCTTAG
CGTGTCTGTTCTCATT-1	TAGCTATCAG	TGTCAATCGTTCGGTTGAGCAAGATCTTAG
CGTTCTGGTTGTGGCC-1	GTCTGATCGT	------------------------------
CGTTCTGGTTGTGGCC-1	AAGTCCGTGC	TGTCAATCGTTCGGTTGAGCAAGATCTTAG
CTAACTTGTCCGAATT-1	AGCCCTTTCC	------------------------------
CTAACTTGTGGGTATG-1	GGCGTTAGAC	------------------------------
CTAACTTTCACAACGT-1	TCATGCCGCG	TGTCAATCGTTCGGTT--------------
CTAAGACAGTACGTTC-1	TAATATCGCG	TGTCAATCGTTCGGTTGAGCAAGATCTTAG
CTAAGACTCTCGATGA-1	ACTTCATGAT	TGTCAATCGTTCGGTT--------------
CTAAGACTCTCGATGA-1	TAACTGATTC	TGTCAATCGTTCGGTTGAGCAAGATCTTAG
CTACACCCACTATCTT-1	GCCGGGTTAT	TGTCAATCGTTCGGTTGAGCAAGATCTTAG
CTACATTGTCATGCCG-1	CCAAAACGAT	------------------------------
CTACATTTCATTCACT-1	GTATAAGCGT	TGTCAATCGTTCGGTTGAGCAAGATCTTAG
CTACCCATCCGCAAGC-1	TGCTTTACTT	------------------------------
CTACCCATCCGCAAGC-1	GCGAAAGGAC	TGTCAATCGTTCGGT---------------
CTACCCATCCGCAAGC-1	TTGTTACATA	TGTCAATCGTTCGGTTGAGCAA--------
CTACGTCCAAAGAATC-1	TTTCATGTTT	------------------------------
CTAGTGAGTCAAAGAT-1	GTTCGAAAAC	------------------------------
CTAGTGAGTCAAAGAT-1	TATCCTATAT	TGTCAATCGTTCGGTTGAGCAAGATCTTAG
CTAGTGAGTCCAGTTA-1	AATTACTTGT	TGTCAATCGTTCGGTTGA------------
CTAGTGAGTTGTGGCC-1	TGTGTGGTGG	------------------------------
CTAGTGAGTTGTGGCC-1	TGCAGATCTC	TGTCAATCGTTCGGTTGAGCAAGATCTTAG
CTCACACCAACGCACC-1	TACATACATA	TGTCAATCGTTCGGTTGAGCAAGATCTTAG
CTCAGAAAGAGACTAT-1	AACAGTTCAA	------------------------------
CTCATTACAGCTGCAC-1	ATCGTAGACC	------------------------------
CTCGAGGCAATGGAAT-1	TTGGCACCGG	------------------------------
CTCGGAGGTTCCGTCT-1	ACCCTATTTT	------------------------------
CTCGGGAAGAACTCGG-1	TGGTTTTGCA	------------------------------
CTCGGGACATCGGACC-1	AAACGCTTTC	TGTCAATCGTTCGGTTGAGCAAGATCTTAG
CTCGGGATCTTGGGTA-1	CATACCTGAC	------------------------------
CTCGTACTCCTGCTTG-1	TGTTCAACAG	------------------------------
CTCTAATCAATTCCTT-1	GAATCCTTTT	TGTCAATCGTTCGGTTGAGCAAGATCTTAG
CTGAAGTAGTGACATA-1	GGAGTTAAAA	------------------------------
CTGAAGTGTAGCGCTC-1	TTCCCTAGAG	------------------------------
CTGAAGTGTTACTGAC-1	TTACATATCT	------------------------------
CTGATAGCACCTGGTG-1	TGCTTAAAAT	------------------------------
CTGCCTACACAGTCGC-1	TTCATCTGCT	------------------------------
CTGCCTAGTACTCTCC-1	GCTTAGATAC	------------------------------
CTGCCTAGTAGGCTGA-1	GACTTCAGAC	------------------------------
CTGCGGAAGCATGGCA-1	GCTACCAAAG	TGTCAATCGTTCGGTTGAGC----------
CTGCGGAGTTTACTCT-1	AGTGTCATGG	TGTCA-------------------------
CTGTGCTTCAATAAGG-1	TAATTTTTTG	------------------------------
CTGTGCTTCAATAAGG-1	AATTTCACGT	TGTCAATCGT--------------------
CTGTGCTTCAATAAGG-1	CCATTAATAG	TGTCAATCGTTCGGTTGAGCAAGATCTTAG
CTGTGCTTCGCTTGTC-1	CGTTAGATAC	TGTCAATCGTTCGGTTGAGCAAGATCTTAG
CTGTGCTTCTACCAGA-1	TTGAACCGGC	TGTCAATCGTTCGGTTGAGCAAGATCTTAG
CTGTGCTTCTTTACAC-1	CCTTAGTCCG	TGTCAATCGTTCGGTTGAGC----------
CTTAACTTCCCTGACT-1	CATCACCGGA	TGTCAATCGTTCGGTTGAGCAAGATC----
CTTACCGGTTTAAGCC-1	TTCAATAGAT	------------------------------
CTTCTCTCAACTGGCC-1	TTGTAAATCG	------------------------------
CTTGGCTGTGTGGTTT-1	ACGCGAGCGC	TGTCAATCGTTCGGTTGAGCAAGATCTTAG
CTTGGCTTCATGTGGT-1	TTCGCAGCTG	------------------------------
CTTTGCGTCGGTTCGG-1	CATCGTAGCA	------------------------------
GAAACTCAGTACATGA-1	ACAGCTTACG	TGT---------------------------
GAAACTCTCAGAGACG-1	AAATGGACTA	------------------------------
GAAACTCTCAGAGACG-1	ACTACGGGGA	TGTCAATCGTTCGGTTGAGCAAGATCTTAG
GAAACTCTCGAGCCCA-1	AAATTCATTG	TGTCAATCGTTCGGTTGAGCAAGATCTTAG
GAAATGACATGACGGA-1	TATGATTCAC	------------------------------
GAAATGACATGACGGA-1	TCCATTTTTG	------------------------------
GAAATGACATGACGGA-1	CGTATAGTTT	TGTCAATCGTTCGGTTGAGCAAGATC----
GAAATGAGTTCCGTCT-1	ATTTCTGGGC	------------------------------
GAACCTATCTGTACGA-1	GTGACCAGTG	TGTCAATCGTTCGGTTGAGCAAGATCTTAG
GAACGGAGTAAGTAGT-1	CCCAGGTCAA	TGTCAATCGTTCGGTTGAGCAAGATCTTAG
GAAGCAGCACTCTGTC-1	TACATGGTTT	TGTCA-------------------------
GAATAAGTCTGCAAGT-1	ATTTCTCTAG	TGTCAATCGTTCGGTTGAGCAAGATCTTAG
GACAGAGCACCTCGTT-1	TAATCAATTG	------------------------------
GACCAATGTCCTCCAT-1	GTTTGACGAT	TG----------------------------
GACCTGGAGGTGATAT-1	GGAGGGGCTG	------------------------------
GACCTGGTCCGTAGTA-1	TCGTTTGAAC	TGTCAATC----------------------
GACCTGGTCCGTAGTA-1	TACCTCTTTT	TGTCAATCGTTCGGTTGAGCAAGATCTTAG
GACGCGTAGATCGATA-1	AACTGCAGGC	------------------------------
GACGGCTGTCTTCTCG-1	GACCTATTTG	TGTCAATCGTTCGGTTGAGCAAGATCTTAG
GACGGCTTCCACGAAT-1	AATATAGGCG	TGTCAATCGTTCGGTTGAGCAAGATCTTAG
GACGGCTTCTTAGCCC-1	TAGCCAATGC	------------------------------
GACGGCTTCTTAGCCC-1	ATTGATTCAT	TGTCAATCGT--------------------
GACGTGCAGGCTACGA-1	TAGGTTATAG	TGTCAATCGTTCGGTTGAGCAAGATCTTAG
GACGTTAAGGTGACCA-1	TTTAGGTGTG	TGTCAATCGTTCGGTTGAGCAAGATCTTAG
GACGTTACACATGGGA-1	CGGGTTAGGT	TGTCAATCGCGCGGTTGAGCAAGATCTTAG
GACGTTAGTTCATGGT-1	TTTCAGTATG	------------------------------
GACGTTATCGAATGGG-1	CTTGAGACGG	------------------------------
GACTACACAGCCAGAA-1	ATCGTCTGTT	------------------------------
GACTGCGTCCTGTACC-1	CTTTTCTCGG	TGTCAATCGTTCGGTTGAGCAAG-------
GAGCAGAAGAGTCTGG-1	AAAGTTGGTT	------------------------------
GAGGTGATCACCGGGT-1	CGCCGAGTTT	------------------------------
GAGTCCGTCCGGGTGT-1	CCACTGCAGC	------------------------------
GATCAGTAGCTCCTTC-1	CTAAATGCAT	TGTCAATCGTGCGGTTGAGCAAGATCTTAG
GATCAGTAGTAGGTGC-1	CAGTTTCCGT	------------------------------
GATCAGTAGTAGGTGC-1	TCGTCTGCCA	------------------------------
GATCAGTCAATCACAC-1	CTTTGATGAG	TGTCAATCGTTCGGTTGAGCAAGATCTTAG
GATCAGTGTCGGCACT-1	TTGCATCCCG	------------------------------
GATCGCGAGAGTTGGC-1	TTCGTCAGGG	TGTCAATCGTTCGGTTGAGCAAGATCTTAG
GATCGTAGTCCAGTTA-1	TCCCAGGAGT	GGTCTCCCTATACCAACAGTATCGTCTCAA
GATCGTAGTTTGACAC-1	CAGCGGTATT	------------------------------
GATCTAGAGGCATGTG-1	TAGGCGATTC	------------------------------
GATCTAGCAATCTGCA-1	GACAACTATG	TGTCAATCGTTCGGTTGAGCAAGATCTTAG
GATCTAGTCTGGTTCC-1	GAAACACGGG	TGTCAATCGTTCGGTTG-------------
GATGAAAAGTCCATAC-1	ATATAGTCGG	TGTCAATCGTTCGGTTGAGCAAGATCTTAG
GATGAAAAGTCCATAC-1	GTCTTTAGGT	TGTCAATCGTTCGGTTGAGCAAGATCTTAG
GATGAAAAGTCCATAC-1	TGTCTTTTGT	TGTCAATCGTTCGGTTGAGCAAGATCTTAG
GATGAGGGTCACAAGG-1	TCACTAAGGG	------------------------------
GATGAGGGTTATCACG-1	CCTTGAAATG	TGTCAATCGTT-------------------
GATGAGGTCCTCCTAG-1	ATTGTCGCTA	TGTCAATCGTTCGGTTGAGCAAGATCTTAG
GATGCTAAGATCCTGT-1	GGTGTACAGC	------------------------------
GATGCTAAGTAGATGT-1	GCGGGACAGG	------------------------------
GATGCTAGTCTGATTG-1	AGCTTCATTT	TGTCAATCGTTCGGTTGAGCAA--------
GATTCAGAGTGACATA-1	TCTTTGCCCC	TGTCAATCGTTCGGTTGAGCAAGATCTTAG
GATTCAGTCTAAGCCA-1	GCAACGTTCT	------------------------------
GCAAACTCAATGGATA-1	ATCACTAATT	TGTCAATCGTTCGGTTGAGCAAGATCTTAG
GCAATCAGTGTAACGG-1	CCATTGTTCC	------------------------------
GCACATATCTTGTATC-1	AAGGATGCAA	TGTCAATCGTTCGGTTGAGCAAGATCTTAG
GCACTCTAGCTTATCG-1	AGGAGCCTGC	------------------------------
GCAGCCACAACTTGAC-1	CCATTTGCGG	TGTAAATCGTTCGGTTGAGCAAGATCTTAG
GCAGCCACAGCCAGAA-1	ACCGCCCTAA	TGTCAATCGTTCGGTTGAGCAAGATCTTAG
GCAGCCACAGCCAGAA-1	CATGGGGAAT	TGTCAATCGTTCGGTTGAGCAAGATCTTAG
GCAGCCATCAGGCCCA-1	CGGTCGTCGC	------------------------------
GCATACAAGGGTCGAT-1	AGTTATTCCA	TGTCAATCGTTCGGTTGAG-----------
GCATACACATGGTAGG-1	CTATTTCAGC	TGTCAATCGTTCGGTTGAGCAAGATCTTAG
GCATGATGTTGCGCAC-1	ATGTGCTCGA	TGTCAATCGTTCGGTTGATCAAGATCTTAG
GCATGCGGTTCCACAA-1	TTCAAAGGAT	TGTCAATCGTTCGGTTGAGCAAGATCTTAG
GCATGTACATTCACTT-1	AGTAGGCCAT	TGTCAATCGTTCGGTT--------------
GCATGTAGTCCCTACT-1	AGTTGCCCTC	------------------------------
GCATGTAGTGATGCCC-1	GTATCTTGTC	------------------------------
GCCAAATAGGTAGCTG-1	TTCCCATTTT	------------------------------
GCCAAATAGGTAGCTG-1	ACTCTGTTGA	TGTCAATCGTTCGGTGGAGCAAGATCTTAG
GCCAAATCACAGACAG-1	AATTATACAT	------------------------------
GCCTCTACAGCTGCAC-1	CGGTGGATTT	------------------------------
GCCTCTACAGCTGCAC-1	TTATTTGAGT	TGTCAATCGTTCGGTTGAGCAAGATCTTAG
GCGACCAAGATGTGGC-1	AACTGTCCTG	TGTCAATCGTTCGGTTGAGCAAGATCTTAG
GCGACCACATGGAATA-1	GTACTATGTG	TGTCAATCGTTCGGTTGAGCAAGATCTTAG
GCGACCAGTACCTACA-1	CACGATGTAT	------------------------------
GCGAGAAAGAAGGTGA-1	TGACGCTACC	TGTCAATCGTTCGGTTGAGCAAGATCTTAG
GCGAGAATCGGATGGA-1	AGTCACCTGG	------------------------------
GCGCAACTCAGAGACG-1	TAAGCTTCAG	------------------------------
GCGCAGTTCTACTCAT-1	AACCAGGTAG	------------------------------
GCGCCAAGTTTAAGCC-1	TTTGAGAAGA	TGTCAATCGTTCGGTTGAGCAAGATCTTAG
GCGCCAATCCCTTGCA-1	ATTTCCTTGC	TGTCAATCGTTCGGTTGAGCAAGATCTTAG
GCGGGTTTCAGTACGT-1	AAGGTAAGCC	TGTCAATCGTTCGGTTGAGCAAGATCTTAG
GCTCCTACACGACGAA-1	AGACGTACTC	------------------------------
GCTCTGTCAGCATACT-1	TTCAAACATG	------------------------------
GCTCTGTCAGCATACT-1	ATTGGATATG	TGTCAATCGTTCGGTTGAGCAAGATCTTAG
GCTCTGTTCGCTTAGA-1	CTCATCATTG	TGTCAATCGTTCGGTTGAGCAAGATCTTAG
GCTGCTTGTCTAGCCG-1	ACTTCAGATG	TGTCAATCGTTCGGTTGAGCAAGATCTTA-
GCTGCTTTCGAGAGCA-1	GCCATATTAC	------------------------------
GCTGCTTTCGGCATCG-1	TCAAGTATCA	TGTCAATCGTTCGGTTGAGCAAG-------
GCTGCTTTCGGCATCG-1	GCTCTGAATT	TGTCAATCGTTCGGTTGAGCAAGATCTTAG
GCTGGGTAGATAGGAG-1	GACAATGGTG	TGTCAATCGTTCGGTTGAGCAAGATC----
GCTGGGTAGTGGACGT-1	TATTTAGAGG	TGTCAATCGTTCGGTTGAGCAAGATCTTAG
GCTGGGTCAGATCTGT-1	ATTTGTAGGG	------------------------------
GCTGGGTGTGAAGGCT-1	ATTTGTTTAG	TGTCAATCGTTCGGTTG-------------
GCTTCCACACGAAACG-1	CGCAGGTTTT	TGTCAATCGTTCGGTTGAGCAAGATCTTAG
GCTTCCAGTCGGCACT-1	TGCACATTTG	TGTCAATCGTTCGGTTGAGCAAGATCTTAG
GCTTCCATCATGTAGC-1	ATGATCGTTA	TGTCAATCGTTCGGTT--------------
GCTTGAAGTTAAGAAC-1	TGGACTTGAC	------------------------------
GCTTGAAGTTAAGAAC-1	CGCCTTATAC	TGTCAATCGTTCGGTTGAGCAAGATCTTAG
GCTTGAATCCATTCTA-1	CGCGAATGCT	TGTCAATCGTTCGGTTGAGCAAGATCTTAG
GGAAAGCGTTATGTGC-1	TTCCTTCAGT	------------------------------
GGAATAATCTCACATT-1	TACAAGGCAG	------------------------------
GGACAGAAGATGTTAG-1	GCCCGTGGAT	------------------------------
GGACAGAGTTTCCACC-1	GAGCTCAATC	TGTCAATCGTTCGGTTGAGCAAGATCTTAG
GGACAGATCAACACCA-1	CTTCCGTACA	------------------------------
GGACATTTCAGTTCGA-1	TTGCTCTACT	------------------------------
GGACGTCGTGAGTATA-1	TACCAATTCA	TGTCAATCGTTCGGTTGAGCAAGATCTTAG
GGACGTCTCCTTTCGG-1	AACGTCAAAC	TGTCAATCGTTCGGTTGAGCAAGATCTTA-
GGAGCAAAGAATTCCC-1	TACCAAATAT	------------------------------
GGAGCAAAGAATTCCC-1	ATATGAAATA	TGTCAATCGTTCGGTTGAGCAAGATCTTAT
GGAGCAAGTGGAAAGA-1	ATACTTAACT	------------------------------
GGAGCAATCCTTGGTC-1	CAATAATAGC	TGTCA-------------------------
GGATGTTAGAAACGAG-1	ATAATCTACT	TGTCAATCGTTCGGTTGAGCAAGATCTTAG
GGATGTTTCGTCGTTC-1	AGCTCATAAT	------------------------------
GGATTACAGCTACCGC-1	TTCCTTACTG	TGTCAATCGTTCGGTTGAGCAAGATCTTAG
GGATTACAGTATTGGA-1	CATTTTCTTA	------------------------------
GGCAATTTCATGCATG-1	ACCAGGGTTC	TGTCAATCGTTCGGTTGAGCAAGATCTTAG
GGCCGATAGAGTACAT-1	TTCTTTGTTT	TGTCAATCGTTCGGTTGAGCAAGATCTTAG
GGCCGATAGTCCGTAT-1	ATTATGGGTC	------------------------------
GGCCGATGTACGCTGC-1	GATTCGTCGT	------------------------------
GGCCGATGTTACCGAT-1	CGAGAATTAT	TGTCAATCGTTCGGTTGAGCAAGATCTTAG
GGCCGATTCCCTAACC-1	TAGTCCGTCG	------------------------------
GGCCGATTCTAGCACA-1	GTCATGCTAC	TGTCAATCGTTCGGTTGAGCAAGATCTTAG
GGCGACTGTATGGTTC-1	GGGATGCAAC	------------------------------
GGCTCGACACGCATCG-1	TATGGGGGGA	------------------------------
GGCTGGTAGGGATGGG-1	TACTTCTGTT	------------------------------
GGGAATGAGAGCCCAA-1	ATAGCCGGTC	------------------------------
GGGAGATCACAGAGGT-1	TCATTCAAGC	------------------------------
GGGAGATGTTAAAGAC-1	CGTAGCGATA	TGTCAATCGTTCGGTTGAGCAAGATCTTAG
GGGATGACACCCAGTG-1	GACACATAGC	------------------------------
GGGATGACACCCAGTG-1	ATCCGCTAAA	TGTCAATCGTTCGGTTGAGCAAGATCTTAG
GGGATGATCAATACCG-1	CGAACGAGAA	------------------------------
GGGCACTCACCACCAG-1	CTAAAATATT	------------------------------
GGGCACTCACTACAGT-1	TAGGTATCAT	TGTCAATCGTTCGGTTGAGCAAGATCTTAG
GGGCACTGTGTATGGG-1	TGATAAGTTA	TGTCAATCGTTCGGTTGAGCAAGATCTTAG
GGGCATCAGAGACTTA-1	CTAGACGCAG	TGTCAATCGTTCGGTTGAGCAAGATCTTAG
GGGCATCTCATCATTC-1	ATGCGCGGAT	TGTCAATCGTTCGGTTGAGCAAGATCTTAG
GGGTCTGTCAATACCG-1	ACACGCTTCC	TGTCAATCGTTCGGTTGAGCAAGATCTTAG
GGGTCTGTCTGCTGCT-1	TCACCCTATT	TGTCAATCGTTCGGTTGAGCAAGATCTTAG
GGGTCTGTCTGGAGCC-1	GACAGAGCAC	TGTCAATCGTTCGGTTGAGCATGATCTTAG
GGTATTGAGGCATGTG-1	GTTTCAGTCC	TGTCAATCGTTCGGTTGAGCAAGATCTTAG
GGTGAAGCACTTCTGC-1	GGAAATTCGA	TGTCAATCGTTCGGTTGAG-----------
GGTGCGTAGATAGCAT-1	TGTGGTGTCA	GGGTTCTGGGATATTACGTTGACTTGAG--
GGTGTTACATCCGGGT-1	AGTCAAGATG	TGTCAATC----------------------
GGTGTTACATCCGGGT-1	ATTAACATGC	TGTCAATCGTTCGGTTGAGCAAGATCTTAG
GGTGTTAGTTGTGGCC-1	AGATGGAACC	------------------------------
GTAACGTTCACATAGC-1	TTGGGAAGCC	TGTCAATCGTTCGGTTGAGCAAGAT-----
GTAACGTTCAGTCCCT-1	TGGGTCCTTA	------------------------------
GTACGTAAGGAATTAC-1	GTCGCTAGAG	------------------------------
GTACTCCCAGTCGTGC-1	GTGAAATGTG	------------------------------
GTAGGCCGTTTGACTG-1	AAACGGCGAG	------------------------------
GTAGTCACACAGATTC-1	TAGTCCATGT	------------------------------
GTAGTCATCACCAGGC-1	CAGCACTACT	TGTCAATCGTTCGGTTGAGCAAGATCTTAG
GTAGTCATCCGCATCT-1	TATAAAGGCC	------------------------------
GTATCTTAGTGAACGC-1	ACTCTATAAT	------------------------------
GTATCTTAGTGAACGC-1	TCCCCAAGTT	TGTCAATCGTTCGGTT--------------
GTATTCTGTGTCCTCT-1	TAGCGGTGGC	TGTCAATCGTTCGGTTGAGCAAGATCTTAG
GTCAAGTCACAGACTT-1	ATTTCGCCTT	TGTCAATCGTTCGGTTGAG-----------
GTCAAGTCAGGATTGG-1	AAACTGTCGG	------------------------------
GTCAAGTCAGGATTGG-1	AACCTACGCG	TGTCAATCGTTC------------------
GTCAAGTCAGGATTGG-1	GCCTCCATTC	TGTCAATCGTTCGGTTGAGCAAGATCTTAG
GTCACAACAGGAATCG-1	TTGCTGTTTG	TGTCAATCGTTCGGTTGAGCAAGATCTTAG
GTCACAAGTTGGTTTG-1	GTAAGATATT	TGTCAATCGTTCGGTTGAGCAAGATCTTA-
GTCACAATCAAACGGG-1	CCTCGCCCGG	------------------------------
GTCACGGCATGTTGAC-1	TTCTGATTTA	TGTCAATCGTTCGGTTGAGCAAGATCTTAG
GTCCTCAGTGCAGGTA-1	GTCTCTGCCG	TGTCAATCGTTCGGTTGAGCAAGATCTTAG
GTCCTCATCACCAGGC-1	TCCGCTTTAT	TGTCAATCGTTCGGTTGAGCAAGATCTTAG
GTCGGGTAGCCAGTTT-1	CGTAGTGATG	------------------------------
GTCGGGTCAACTGCGC-1	GGACTGATTC	------------------------------
GTCGTAAAGACTAGAT-1	CGTGAGGGGG	TGTCAATCGTTCGGTTG-------------
GTCGTAAAGACTAGAT-1	TTTTGCTTCC	TGTCAATCGTTCGGTTGAGCAAGATCTTAG
GTCGTAAGTTGACGTT-1	TTACGATCAG	------------------------------
GTCGTAATCTCCAACC-1	ACTTGTAGCT	TGTCAATCGTTCGGTTGAGCAAGATCTTAG
GTCTCGTGTTATTCTC-1	ACGACATGGT	TGTCAATCGG--------------------
GTCTTCGAGTGGACGT-1	GATCGCTATA	GGTCTCCCTATACCAACAGTATCGTCTCAA
GTGCAGCGTGCCTGGT-1	TTACGATGGA	TGTCAATCGTTCGGTTGAGCAAGATCTTAG
GTGCAGCTCCTATTCA-1	GTTGCTACTG	TGTCAATCGTTCGGTTGAGCAAGATCTTAG
GTGCATAGTCTTCGTC-1	CGACACTTTG	------------------------------
GTGCATAGTCTTCGTC-1	ATAGTGCCCA	TGTCAATCGTTCGGTTGAGCAAGATCTTAG
GTGCGGTCACCCAGTG-1	AGCACGCTTC	TGTCAATCGTTCGGTTGAGCAAGATCTT--
GTGCGGTGTCAAGCGA-1	AACACAGCCG	------------------------------
GTGTGCGTCACGACTA-1	TCCGCGCTTT	------------------------------
GTTAAGCGTAGCTCCG-1	GTAATATCTT	TGTCAATCGTTCGGTTGAGCAAGATCTTAG
GTTAAGCGTCTAAACC-1	TTCATCAAGC	TGTCAATCGTTCGGTTGAGCAAGATCTTAG
GTTCATTCATGTCCTC-1	GGGGCCCTTG	------------------------------
GTTCTCGAGGCTCAGA-1	TGGTTGTCCT	------------------------------
GTTCTCGAGGCTCAGA-1	TAGTCGTTCG	TGTCAATCGTTCGGTTGAGCAAGATCTTAG
TAAACCGCATCCGGGT-1	ATATTGTTGG	TGTCAAT-----------------------
TAAACCGTCAATCTCT-1	ATGCAAGTGT	TGTCAATCGTTCGGTTGAGCAAGATCTTAG
TAAGCGTCAGTCTTCC-1	ACATGGCCTC	------------------------------
TAAGTGCTCCCTAACC-1	AGTGAGACAT	TGTCAATCGTTCGGTTGAGCAAGATCTTAG
TACACGACAGCAGTTT-1	AGAGCAATTG	TGTCAATCGTTCGGTTGAGCAAGATCTTA-
TACACGAGTGCGGTAA-1	ATATCGTAAG	------------------------------
TACAGTGAGAGCTTCT-1	TACACGCTAA	------------------------------
TACAGTGAGAGCTTCT-1	GAATTACATA	TGTCAATCGTTCGGTTGAGCAAGATCTTAG
TACAGTGGTATGAATG-1	TGCCAGGTAA	------------------------------
TACCTATAGAGTGAGA-1	GGTAATTTAG	------------------------------
TACCTTAGTAGTGAAT-1	GGCAACCCTT	------------------------------
TACGGATAGAAACGCC-1	CGCAAGCTAT	TGTCAATCGTTCGGTTGAGCAAGATCTTAG
TACGGATTCAGAAATG-1	TCCCGTAGTT	------------------------------
TACGGATTCAGTTGAC-1	GGATTTAAAT	------------------------------
TACGGATTCAGTTGAC-1	CACACCCCTA	TGTCAATCGTTCGGTTGAGCAAGATCTTAG
TACGGATTCGGATGTT-1	GTAACGAAGG	------------------------------
TACGGGCAGTGGAGAA-1	TTAACACACC	TGTCAATCGTTCGGTTGAGCAAGCTCTTAG
TACGGTAAGCGGATCA-1	TCTTGAAATT	TGTCAATCGTTCGGTTGAGCAAGA------
TACTCATAGTACGTAA-1	CTGTTCACCG	TGTCAATCGTTC------------------
TACTCATTCCTTTCTC-1	TTATACATCG	TGTCAATCGTT-------------------
TACTCGCTCTAGCACA-1	GTTAGTTGAA	TGTCAATCGTTCGGTTGAGCAAGATCTTAG
TACTTACCATAGTAAG-1	TCGCTCTTCT	TGTCAATCGTTCGGTTGAGCAAGATCTTAG
TACTTGTAGCGCCTCA-1	ACCTCCGCAT	------------------------------
TAGACCAGTCAGAAGC-1	CTGTCCCGCT	------------------------------
TAGAGCTAGCTAGCCC-1	ACGAACGCAT	TGTCAATCGTTCGGTTGAGCAAGATCTTAG
TAGAGCTAGTGCAAGC-1	CGCCGCTCGT	TGTCAAT-----------------------
TAGAGCTCAGGTTTCA-1	GCTAACTTTT	------------------------------
TAGAGCTCAGGTTTCA-1	TTGACCAATT	------------------------------
TAGAGCTCAGGTTTCA-1	TTGGCTCGCT	------------------------------
TAGCCGGGTGCTCTTC-1	ATATAAGTAT	------------------------------
TAGCCGGGTGCTCTTC-1	TTTTTCGAAA	TGTCAATCGTTCGGTTGAGCAAGATCTTAG
TAGGCATAGCCAGTTT-1	TCTCAATCTT	------------------------------
TAGGCATAGCCAGTTT-1	ATTTCTAGGA	TGTCAATCGTTCGGTTGAGCAAGATCTTAG
TAGGCATAGGCGATAC-1	CCTTAATGGA	------------------------------
TAGGCATAGGCGATAC-1	TGTGTGAGAG	TGTCAATCGTTC------------------
TAGGCATAGGTAGCTG-1	GATTGGAATT	------------------------------
TAGGCATGTGTGACGA-1	ACTATGCTAC	TGTCAATCGTTCGGTTGAGCAAGATCTTAG
TAGTGGTGTTCTCATT-1	ACACCCCATA	TGTCAATCGTTCGGTTGAGCAAGATCTTAG
TATGCCCCATGACATC-1	TTATCGGGAC	TGTCAATCGTTCGGTTGAGCAAGATCTTAG
TATTACCTCCTAGGGC-1	ATGTGCTATC	TGTCAATCGTTCGGTTGAGCAAGATCTTAG
TCAACGAAGCCGATTT-1	TATTCATGGT	------------------------------
TCAACGAAGGCAATTA-1	GACTTTCGGT	TGTCAATCGTTCGGTTGAGCAAGATCTTAG
TCAATCTTCGGCGCAT-1	GCTTGTTATG	TGTCAATCGTTCGGTTGAGCAAGATCTTAG
TCAATCTTCTCGCTTG-1	CGTGCACAGG	TGTCAACCGTTCGGTTGAGCAAGATCTTAG
TCACAAGTCGGCATCG-1	CACTACCCTA	TGTCAATCGTTCGG----------------
TCACGAAGTGTGACGA-1	CCTGGTCTTT	TGTCAATCGTTCGGTTGAGCAAGATCTTAG
TCAGCAAAGGGAACGG-1	GCTATGAACA	------------------------------
TCAGCTCCAGCTATTG-1	GCTCCCCCCA	TGTCAATCGTTCGGTTGAGCAAGATCTTAG
TCAGCTCGTCCTGCTT-1	GGCCTAGTTT	------------------------------
TCAGCTCGTCCTGCTT-1	TATATATGTT	------------------------------
TCAGCTCGTCCTGCTT-1	TATTTACACT	------------------------------
TCAGCTCTCTGTCAAG-1	AACCACTTCC	TGTCAATCGTTCGGTTGAGCAAGATCTTAG
TCAGGTAGTCTAGAGG-1	TGGGGTAGCG	TGTCAATCGTTC------------------
TCATTACTCCTGCTTG-1	CGCTATTTAC	------------------------------
TCATTTGGTCCGCTGA-1	CCTGGTCCTT	TGTCAATCGTTCGGTTGAGCAAGATCTTAG
TCATTTGTCGAACTGT-1	AGTCTATCGT	------------------------------
TCCACACAGCGAGAAA-1	AACGGGTCCC	------------------------------
TCCACACAGCGAGAAA-1	CAATATCGGG	TGTCAATCGTTCG-----------------
TCGAGGCAGATATGGT-1	GTTTAGTCTG	------------------------------
TCGAGGCCAGGTCTCG-1	TTGTTGGTTA	------------------------------
TCGCGAGTCACCTTAT-1	GAAGTGTCGT	------------------------------
TCGCGTTAGGACCACA-1	ATCCGCACCG	TGTCAATCG---------------------
TCGGGACAGTTCCACA-1	AGAAGTTGTA	TGTCAATCGTTCGGTTGAGCAAGATCTTA-
TCGGGACTCCATTCTA-1	ACGCTTCTAT	TGTCAATCGTTCGGTTGAGCAAGATCTTAG
TCGGGACTCCTCCTAG-1	CCTGATTCAT	------------------------------
TCGTACCGTGATGTGG-1	CACGTAATAG	TGTCAATCGTTCGGTTGAGCAAGATCTTAG
TCGTAGAGTAATTGGA-1	CGGAACTCGC	------------------------------
TCTCATAGTGTTAAGA-1	ACGATAGCAT	------------------------------
TCTCATAGTTGGTGGA-1	TCCACTACTC	------------------------------
TCTGAGAGTGTGACCC-1	AAGTACATAC	------------------------------
TCTGAGAGTGTGACCC-1	TTGGTGTATC	------------------------------
TCTGAGATCTTACCTA-1	CTATATTATA	------------------------------
TCTGGAACATATACGC-1	GAAGTCAGGG	------------------------------
TCTGGAACATATACGC-1	TGTTCCGCAC	------------------------------
TCTGGAAGTGATGCCC-1	TTTCTTTAAA	TGTCAATCGTTCGGTTGAGCAAGATCTTAG
TCTTCGGGTGTAATGA-1	CGTTCTAAAA	TGTCAATCGTTCGGTTGAGCAAGCTCTTAG
TCTTTCCAGTCGATAA-1	GTTAAAGCAG	------------------------------
TCTTTCCCAGATTGCT-1	GTGTTAGAGC	TGTCAATCGTTCGGTTGAGCAAGATCTTAG
TCTTTCCCAGATTGCT-1	TGTGGTTTAT	TGTCAATCGTTCGGTTGAGCAAGATCTTAG
TGACAACAGCCACGTC-1	ATCCCTTTTT	------------------------------
TGACAACTCCTATGTT-1	GATGACCAAC	TGTCAATCGTTCGGTTGAGCAAGATCTT--
TGACGGCTCGCGATCG-1	CCAGAGTTAT	------------------------------
TGACTAGTCGCAAACT-1	CAACGCATTT	TGTCAATCGTTCGGTTGAGCAAGATCTTAG
TGAGAGGAGTACACCT-1	TGAACTGCCG	TGTCAATCGTTCGGTTGAGCAAGATCTTAG
TGAGCATAGGATATAC-1	GTTACTCTAG	TGTCAATCGTTCGGTTGAGCAAGATCTTAG
TGAGCATGTCTCTCTG-1	GCCAGTCGCG	TGTCAATCGTTCGGTTGAGCAAGATCTTAG
TGAGGGAAGTAACCCT-1	GACAAGCATC	TGTCAATCGTTCGGTTGAGCAAGATCTTAG
TGAGGGAAGTGGTCCC-1	CAGTAAAGTT	TGTCAATCGTTCGGTTGAGCAAGATCTTAG
TGATTTCTCGACAGCC-1	TTCAGCTACT	------------------------------
TGCCCATCACACCGAC-1	CAATAGTCTT	------------------------------
TGCCCTAAGGACAGAA-1	ATGCAGAAGG	TGTCAATCGTTCGGTTGAGCAAGATCTTAG
TGCCCTAGTCTTCTCG-1	GAATGGGCAA	------------------------------
TGCGCAGAGCTCTCGG-1	TACAACTTTA	------------------------------
TGCGCAGTCTGGTGTA-1	AGCGGACGCG	TGTCAATCGTTCGGTTGAGCAAGA------
TGCGTGGGTCGCATAT-1	TTAATTGTAA	------------------------------
TGCTACCGTATTCGTG-1	CTCTTCATTT	------------------------------
TGCTACCGTTTGTTTC-1	TATAATCAAC	TGTCAATCGTTCGGTTGAGCAAGATCTTAG
TGCTGCTCACCTGGTG-1	TCGGACTGCA	------------------------------
TGCTGCTCACCTGGTG-1	TGGATCTGAG	TGTCAATCGTTCGGTTGAGCAAGATCTTAG
TGCTGCTGTACCGTAT-1	ATGACCATTT	------------------------------
TGGACGCAGAAACGAG-1	ACCAGGACCT	------------------------------
TGGCCAGAGACTGTAA-1	CGTAACCTAT	TGTCAATCGTTCGGTTGAGCAAGATCTTAG
TGGCGCAAGAATAGGG-1	TCTTCGGTGT	GGGTTCTGGGATATTACGTTGACTTGAGAG
TGGCGCAAGTCGATAA-1	CCACGTCGGA	TGTCAATCGTTCGGTTGAGCAAGATCTTAG
TGGCGCACAACCGCCA-1	CCTCTGAAGA	------------------------------
TGGCGCATCGCCAGCA-1	CGGCAGAGAG	------------------------------
TGGCTGGGTGTGAAAT-1	GGTATGGTGT	TGTCAATCGTTAGGTTGAGCAAGATCTTAG
TGGCTGGGTTTGGCGC-1	TCCACTACAG	TGTCAATCGTTCGGTTGAGCAAGATCTTAG
TGGGAAGAGATCCTGT-1	TTCCATAAGT	------------------------------
TGGGCGTGTAACGTTC-1	TGTAGGTACG	TGTCAATCGTTCTGTTGAGCAAGATCTTAG
TGGGCGTTCCTTGCCA-1	AAAGTTCCGC	TGTCAATCGTTCGGTTGAGCAAGATCTTAG
TGGTTAGAGATGCCTT-1	AAGTCACATT	TGTCAATCGTTCGGTTGAGCAAGATCTTAG
TGGTTAGTCTCGTATT-1	CGTGCCTCGG	TGTCAATCGTTCGGTTGAGCAAGATCTTAG
TGTATTCCAATCGGTT-1	TCCCAGTTTG	TGTCAATCGTTCGGTTGAGC----------
TGTCCCAAGCGTGAGT-1	GGTTGTTGCT	TGTCAATCGTTCGGTTGAGCAAGATCTTAG
TGTCCCAGTTCGTTGA-1	ATGGAAACAG	------------------------------
TGTGGTATCAACCATG-1	CCGTAGGCTG	TGTCAATCGTTCGGTTGAGCAAGATCTTAG
TGTGTTTCAGTCGATT-1	ACACCTTGTT	------------------------------
TGTTCCGTCAGAGACG-1	AATTTGGGAT	TGTCAATCGTTCGGTTGAGCAAGATCTTAG
TTAACTCAGGGTGTGT-1	CTTGGGAAAT	TGTCAATCGTTCGGTTGAGCAAGAACTTAG
TTAACTCCACCAGGCT-1	ATTGTCTCTG	------------------------------
TTAACTCCATGCCTTC-1	TCACATCGCT	TG----------------------------
TTAGGCAAGCAAATCA-1	TTTTCCGTCT	TGTCAATCGTT-------------------
TTAGTTCCATCCAACA-1	GTACTGCCAT	TGTCAATCGTTCGGTTGAGCAAGATCTTAG
TTAGTTCTCGGAGGTA-1	ACCCTAGGGG	------------------------------
TTATGCTTCGGAAATA-1	CCACTAAAGA	------------------------------
TTATGCTTCTAACCGA-1	CTTTTAAGAC	TG----------------------------
TTCCCAGCAAGGACAC-1	TAATTTATTT	TGTCA-------------------------
TTCGAAGGTGACGGTA-1	GGCCCCAATC	------------------------------
TTCGAAGGTGACGGTA-1	TGTTGAACTA	------------------------------
TTCGAAGGTGACGGTA-1	TAGAGTGCAA	TGTCAATCGTTCGGTTGAGCAAGATCTTAG
TTCGGTCAGATCCTGT-1	CATCAATGTA	------------------------------
TTCGGTCTCAGGATCT-1	CCGAAAATTT	------------------------------
TTCGGTCTCAGGATCT-1	TCAACGGACT	TGTCAATCGTTCGGTTGAGCAAGATCT---
TTCGGTCTCAGGATCT-1	AAAGGATGGT	TGTCAATCGTTCGGTTGAGCAAGATCTTAG
TTCTACAGTCGATTGT-1	TTTTAGTCAA	------------------------------
TTCTACATCATGCTCC-1	GAAATTGGGA	------------------------------
TTCTCCTCACAAGACG-1	TTTTCCCATG	TGTCA-------------------------
TTCTTAGCAAGCTGTT-1	TTCTGTTTCA	------------------------------
TTCTTAGCAGACGCCT-1	GGATATGATA	------------------------------
TTCTTAGCAGACGCCT-1	TCGTTCCCAG	TGTCAATCGTTCGGTTGAGCAAGATCTTAG
TTGAACGCAAGCGCTC-1	ATCTTAGAAT	------------------------------
TTGAACGGTACAAGTA-1	GTTAACAAGC	TGTCAATCGTTCGGTTGAGCAAGATCTTAG
TTGAACGGTGGCGAAT-1	TCCGCTTGAT	------------------------------
TTGACTTGTAAATACG-1	CTCTAACTGG	------------------------------
TTGGAACCAGACAAAT-1	ACCATTCTAT	------------------------------
TTGGAACGTCGACTGC-1	GGCCATTAGT	------------------------------
TTTATGCCAAGTTCTG-1	CCCATTAATA	T-----------------------------
TTTCCTCTCTGTCCGT-1	CAACGGTTCG	TGTCAATCGTTCGGTTGAGCAAGATCTTAG
TTTGGTTCATGGATGG-1	GCTGTACAGG	TGTCA-------------------------
