#Each output line corresponds to one read and has the following style: CellID	UMI	Barcode
# dash (-) = barcode base outside of read, 0 = deletion in barcode sequence (position unknown)
CAGCTGGGTTAAAGAC-1	AAAAAGCGTC	TCGGCATGGACGAGCTGTACAAGTAAACGC
GGGATGATCTGATTCT-1	AAAAATCCGA	TCGGCATGG---------------------
GTCAAGTCAAGAAGAG-1	AAAACATTTA	TCGGCATGGACGAGCTGTACAAGTAAACGC
TTAACTCAGCCAGGAT-1	AAAATCAGCT	TCGGCATGGACGAGCTG-------------
TTCCCAGCAAGGTGTG-1	AAAATCCGTT	TCGGCATGGACGAGCTGTACAAGTAAACGC
ACTGTCCTCAGCATGT-1	AAAATCGCAT	TCGGCATG----------------------
CCGGGATGTAAAGGAG-1	AAAATCTGTT	TCGGCATGGACGAGCTGTACAAGTAAACGC
GCGCCAACACGTGAGA-1	AAAATTGCTT	------------------------------
CAGCTGGGTGCCTGTG-1	AAAATTTCTT	------------------------------
CATTATCCAAGAGGCT-1	AAACAAAGGT	TCGGCATGGACGAGCTGTACAAGTAAACGC
CCTTACGAGCAGCCTC-1	AAACCAAGCT	TCGGCATGGACGAGCTGTACAAGTAAACGC
ACCCACTTCTCTTATG-1	AAACCGAATT	TCGGCATGGACGAGCTGTACAAGTAAACGC
AAATGCCTCGCAGGCT-1	AAACGATACG	------------------------------
CTAATGGCATACGCTA-1	AAACGTCTCA	------------------------AAACGC
TCTCTAAAGGCCGAAT-1	AAACTAATTC	TCGGCATGGACGAGCTGTACAAGTAAACGC
AGCCTAACAGACGCCT-1	AAACTCGCTG	------------------------------
AATCGGTTCAAGGCTT-1	AAACTCTGGC	TCGGCATGGACGAGCTGTACAAGTAAACGC
TCACGAATCAGCCTAA-1	AAACTGGATA	------------------------------
TTGGCAACAGGCGATA-1	AAAGGCATTT	------------------------------
CAGCATATCGTTACAG-1	AAAGTCGTTG	TCGGCATGGACGAGCTGTACAAGTAAACGC
ACGGCCAAGAAACGCC-1	AAAGTCTTGT	TCGGCATGGACGAGCTGTACAAGTAAACGC
GTGTGCGGTAGCGCTC-1	AAATACGGTT	TCGGCATGGACGAGCTGTACAAGTAAACGC
GGTGCGTAGTGGACGT-1	AAATACTCTT	TCGGCATGGACGAGCTGTACAAGTAAACGC
CTACCCACAGGTCTCG-1	AAATATACTG	------------------------------
AGACGTTGTGTGCGTC-1	AAATCTAAGA	TCGGCATGGACGAGCTGTACAAGTAAACGC
AGTGGGAGTAAGGGCT-1	AAATCTCCGT	------------------------------
CTCCTAGTCAGCATGT-1	AAATTATCTG	TCGGCATGGACGAGCTGTACAAGTAA----
ATCTGCCAGGGAAACA-1	AACACACCGT	------------------------------
ATGTGTGTCGCTGATA-1	AACACTACGT	------------------------------
CGTCTACGTGCACGAA-1	AACACTCGAA	TCGGCATGGACGAGCT--------------
CCTACCAGTGCAGTAG-1	AACAGCAGGT	TCGGCATGGACGAGCTGTACAAGTAAACGC
GTTCGGGCACCTCGGA-1	AACATGCACG	TCGGCATGGACGAGCTGTACAAGTAAACGC
TCATTACCAAATACAG-1	AACATGCCTA	TCGGCATGGACGAGCTGTACAAGTAAACGC
CCTTACGCACAACGCC-1	AACCATGACC	TCGGCATGGACGAGCTGTACAAGTAAACGC
TGCCAAACAGGCTCAC-1	AACCATTTTA	TCGGCATGGACGAGCTGTACAAGTAAACGC
GCGCAGTAGAAGGTTT-1	AACCCAGTTT	TCGGCATGGACGAGCTGTACAAGTAAACGC
TCACGAACAGTTAACC-1	AACCCCACTC	TCGGCATGGACGAGCTGTACAAGTAATCGC
CGAATGTTCAACCAAC-1	AACCCCATTA	----------------GTACAAGTAAACGC
GAATGAAAGCGAAGGG-1	AACCCCGGCA	TCGGCATGGACGAGCTGTACAAGTAAACGC
GGGAGATGTTCAACCA-1	AACCGAAAGC	TCGGCATGGACGAGCTGTACAAGTAAACGC
ACGGGTCCAATCCGAT-1	AACCGTGTTA	TCGGC-------------------------
ACATGGTAGCTTATCG-1	AACCTATTGG	TCGGCATGGACGAGCTGTACAAGTAAACGC
CCGTACTGTGCAACTT-1	AACCTTGAAG	TCGGCATGGACGAGCTGTACAAGTAAACGC
TGAGAGGTCTGCAAGT-1	AACCTTGTGT	--------GACGAGCTGTACAAGTAAACGC
AACTCTTCAAGCCGCT-1	AACCTTGTTG	------------------------------
ACGAGCCCAAACCCAT-1	AACCTTTTTA	------------------------------
AGCTCTCAGAACTCGG-1	AACGATTTAA	--------------CTGTACAAGTAAACGC
TTAACTCGTTCAGACT-1	AACGCACTTC	TCGGCATGGACGAGCTGTACAAGTAAACGC
TACACGAAGGGTATCG-1	AACGCTCACA	TCGGCATGGACGAGCTGTACAAGTAAACGC
ATAGACCGTAGCGTAG-1	AACGTCCCCA	------------------------------
CCGTTCAAGCTAAGAT-1	AACTAAGGAA	------------------------------
AGATTGCTCAGCTGGC-1	AACTAGTATG	TCGG--------------------------
GATGCTATCGCCAAAT-1	AACTCAACAA	TCGGCATGGACGAGCTGTACAAGTAAACGC
GAGGTGAGTACATCCA-1	AACTCAACGG	TCGGCATGGACGAGCTGTACAAG-------
CTTACCGCAATAAGCA-1	AACTCACGGT	-------GGACGAGCTGTACAAGTAAACAC
ATGTGTGCAATGGAGC-1	AACTCAGAAC	------------------------------
ACGCAGCAGCCACTAT-1	AACTCTGTAT	TCGGCATGGACGAGCTGTACAAGTAAACGC
CTTACCGTCGGATGTT-1	AACTGACCTA	TCGGCATGGACGAGCTGTACAAGTAAACGC
TGGCCAGAGTGGAGTC-1	AACTGGTGGA	------------------------------
AAGTCTGGTGTTGGGA-1	AACTGTAAGG	TCGGCATGGACGAGCTGTACAAGTAAACGC
GGGTTGCAGATCTGCT-1	AACTGTTTTT	TCGGCATGGACGAGCTGTACAAGTAAACGC
CAGAATCTCCGCAAGC-1	AACTTATGAG	TCGGCATGGACGAGCTGTACAAGTAAACGC
CCGTGGATCCCTAACC-1	AACTTCACAA	TCGGCATGGACGAGCTGTACAAGTAAACGC
CCTACCATCCAAACTG-1	AACTTTAATT	TCGGCATGGACGAGCTGTACAAGTAAACGC
TGGGAAGAGTTGCAGG-1	AACTTTTTCA	------------------------------
CGTTAGATCTGCAAGT-1	AAGAACCGCA	TCGGCATGGACGAGCTGTACAAGTAAACGC
ATGAGGGTCGAGCCCA-1	AAGAACTGAC	TCGGCATGGACGAGCTGTACAAGTAAACGC
TGAGCATAGTTGAGTA-1	AAGAAGGTAG	TCGGCATGGACGAGCTGTACAAGTAAACGC
AGCTCCTGTCAGGACA-1	AAGACTAGTG	TCGGCATGGACGAGCTGTACAAGTAAACGC
CTCGGAGTCTGCCAGG-1	AAGACTTGAT	TCGGCATGGACGAGCTGTACAAGTAAACGC
GACGTTAAGCTCAACT-1	AAGATGGCTT	------------------------------
GGGATGATCAGCTTAG-1	AAGATTAGGC	TCGGCATGGACGAGCTGTACAAGTAAACGC
TCAGATGGTTCTGAAC-1	AAGATTAGTT	------------------------------
ACGATGTCAGCCAATT-1	AAGATTGAAT	TCGGCATGGACGAGCTGTACAAGTAAACGC
AATCCAGCATGACATC-1	AAGCAAAAAT	TCGGCC------------------------
CCTAGCTGTCTCATCC-1	AAGCATGGCA	------------------------------
CTCGTACAGGCAATTA-1	AAGCTATTTT	----------------------GTAAACGC
CATCGAAGTCTCATCC-1	AAGCTTCACT	------------------------------
CCTCTGAGTGAAAGAG-1	AAGGACGTGA	TCGGCATGGACGAGCTGTACAAGTAAACGC
CATGACATCGGAATCT-1	AAGGATCGGC	TCGGCATGGACGAGCTGTACAAGTAAACGC
AGTGAGGCAGTAAGAT-1	AAGGCAAACA	TCGGCATGGACGAGCTGTACAAGTAAACGC
TAGACCATCCGAATGT-1	AAGGCCCGTC	TCGGCATGGACGAGCTGTACAAGTAAACGC
AGGGATGGTGTGACGA-1	AAGGCGTGCT	--------------------------TCGG
GAATGAAAGCGAAGGG-1	AAGGCGTTAT	TCGGCATGGACGAGCTGTACAAGTAAACGC
CGATGTATCTACGAGT-1	AAGGCTGAAT	TCGGCATGGACGAGCTGTACAAGTAA----
AAAGCAAGTAGCGTAG-1	AAGGGTGTCT	TCGGCATGGACGAGCTGTACAAGTAAACGC
GAAGCAGTCTCTAGGA-1	AAGGTCTGTT	------------------------------
ACGCCAGCATTGTGCA-1	AAGGTTCAAC	TCGGCATGGACGAGCTGTACAAGTAAACGC
TGGGAAGTCTACGAGT-1	AAGTAAATCA	---------------------AGTAAACGC
TCACGAATCAGCCTAA-1	AAGTAGCGAT	TCGGCATGGACGAGCTGTACAAGTAAACGC
AATCCAGCATTGCGGC-1	AAGTCATGGC	TCGGCATGGACGAGCTGTACAAGTAAACGC
AACGTTGTCGCTGATA-1	AAGTCCAGAT	------------------------------
GAACATCTCTAAGCCA-1	AAGTCCGACA	---------------------------CGC
GATCGCGGTTATTCTC-1	AAGTCTCCTA	-----------GAGCTGTACAAGTAAACGC
ACACCGGTCGTCCGTT-1	AAGTGAACTA	TCGGCATGGACGAGCTGTACAAGTAAACGC
AAACCTGAGCGACGTA-1	AAGTGGACTG	CCGGCATGGACGAGCTGTACAAGTAAACGC
CAAGAAAGTAAATGTG-1	AAGTTGCTGT	------------------------------
CCGTACTGTGCAACTT-1	AAGTTTCCAC	TCGGCATGGACGAGCTGTACAAGTAAACGC
GCGCCAAAGTGAACGC-1	AAGTTTTTTT	TCGGCATGGACGAGCTGTACAAGTAAACGC
GGCGTGTTCATCGCTC-1	AATAAGGTAA	TCGGCATGGACGAGCTGTACAAGTAAACGC
CTCGGGACAGTTTACG-1	AATACAATCG	TCGGCATGGACGAGCTGTACAAGTAAACGC
ACGGGCTGTCACCCAG-1	AATACCCTAG	------------TCGGCATGGACGAGCTGT
GCTCCTAAGAGTAATC-1	AATACCTGGT	------------------------------
GCGCCAACATGTCGAT-1	AATACCTGTC	------------------------------
AAAGTAGAGGGCTCTC-1	AATACTCACG	TCGGCATGGACGAGCTGTACAAGTAAACGC
CACACCTCAGCGTAAG-1	AATACTGAAA	------------------------------
GTCTCGTTCCCAAGTA-1	AATAGAACAG	TCGGCATGGACGAGCTGTACAAGTAAACGC
CGGGTCAGTGAGTATA-1	AATAGCTCTC	TCGGCATGGACGAGCTGTACAAGTAAACGC
AAGTCTGGTGTTGGGA-1	AATAGGAGTT	------------------------------
GGACAGACATGAACCT-1	AATATACCTT	TCGGCATGGACGAGCTGTACAAGTAAACGC
TTAGGCATCTTTACGT-1	AATATCACTG	TCGGCATGGACGAGCTGTACAAGTAAACGC
TCGTAGAAGTGGTAAT-1	AATATGAATT	TCGGCATGGACGAGCTGTACAAGTAAACGC
TCGGGACTCACCTCGT-1	AATATGCCTT	------------------------------
TGTATTCCATCTGGTA-1	AATATGGTGA	TCGGCATGGACGAGCTGTACAAGTAAACGC
AAATGCCAGGACATTA-1	AATATTGGTT	------------------------------
CTACATTCAAAGAATC-1	AATCAACCTG	TCGGCATGGACGAGCTGTACAAGTAAACGC
GTGAAGGGTCAAGCGA-1	AATCAACTAT	TCGGCATGGACGAGCTGTACAAGTAAACGC
AGACGTTGTACCGCTG-1	AATCAATCAG	-------------GCTGTACAAGTAAACGC
CATATGGGTGTGGCTC-1	AATCACTAAG	------------------------------
TTCTCCTAGGCGTACA-1	AATCATCTTA	TCGGCATGGACGAGCTGTGCAAGTAAACGC
CGAATGTTCCTTAATC-1	AATCATGATC	TCGGCATGGACGAGCTGTACAAGTAAACGC
CCCTCCTCACGGTGTC-1	AATCATTGCT	------------------------------
TGCACCTGTGGTCTCG-1	AATCATTTAG	TCGGCATGGACGAGCTGTACAAGTAAACGC
ACGATGTAGGAGCGTT-1	AATCCACTTA	TCAGCATAGACAAGCTGTACAAGTAAACGC
GTTCATTTCGCGATCG-1	AATCCTCTTG	---------ACGAGCTGTACAAGTAAACGC
TGACAACGTCGAACAG-1	AATCCTGCCA	------------------------------
GAGCAGATCTGCTGCT-1	AATCGCTCTG	---------------------AGTAAACGC
CACAGTAGTGTAACGG-1	AATCTATCAG	------------------------------
GCGCGATAGAAGGTTT-1	AATCTGCGAA	TCGGCATGGACGAGCTGTACAAGTAAACGC
GTAACGTAGACGCAAC-1	AATCTTGAGA	------------------------------
AAAGCAAGTAGCGTAG-1	AATGAGCTAG	TCGGCATGGACGAGCTGTACAAGTAAACGC
TTGCCGTAGAGTTGGC-1	AATGCATCGT	TCGGTATGGACGAGCTGTACAAGTAAACGC
CTGGTCTAGGGTTCCC-1	AATGCCTTAC	TCGGCATGGACGAGCTGTACAAGTAAACGC
GTTCGGGCACCTCGGA-1	AATGCTGTAC	TCGGCATGGACGAGCTGTACAAGTAAACGC
GAGGTGAGTACATCCA-1	AATGGAAAAG	TCGGCATGGACGAGCTGTACAAGTAGAC--
CGCCAAGAGAAGATTC-1	AATGGGTACC	TCGGCATGGACGAGCTGTACAAGTAAACGC
TAAGAGACATTAGGCT-1	AATGGTATTT	TCGGCATGGACGAGCTGTACAAGTAAACGC
GAGGTGATCCTCTAGC-1	AATGTACCAT	TCGGCATGGACGAGCTGTACAAGTAAACGC
AATCCAGAGCCGCCTA-1	AATGTACTAA	------------------------------
GTCTCGTTCCCAAGTA-1	AATGTCATTG	TCGGCATGGACGAGCTGTACAAGTAAACGC
TACTCATAGCTGATAA-1	AATGTTTGTA	TCGGCATGGACGAGCTGTACAAGTAAACGC
TGCCAAAAGAGTGAGA-1	AATGTTTTTA	------------------------------
TGAGCATAGTTGAGTA-1	AATTAAATGG	TCGGCATGGACGAGCTGTACAAGTAAACGC
GTCACGGTCTCCCTGA-1	AATTAATGAG	TCGGCATGGACGAGCTGTACAAGTAAACGC
CGCGTTTTCGGTCCGA-1	AATTAATTTC	------------------------------
GAAGCAGGTGCCTGCA-1	AATTACTTTC	----------------GTACAAGTAAACGC
ACTTACTCAGCTTAAC-1	AATTATCTCG	TCGGCATGGACGAGCTGTACAAGTAAACGC
CTCGGGAGTTCGTCTC-1	AATTCAATAG	TCGGCATGGACGAGCTGTACAAGTAAACGC
AGCGTCGGTTGTTTGG-1	AATTCGTTTT	TCGGCATGGACGAGCTGTACAAGTAAACGC
ACGTCAACAGACGCTC-1	AATTCTCGTA	TCGGCATGGACGAGCTGTACAAGTAAACGC
TCGCGTTCAAACTGCT-1	AATTCTCTGA	TCGGCATGGACGAGCTGTACAAGTAAACGC
TGAGCATAGTTGAGTA-1	AATTGCCAGG	TCGGCATGGACGAGCTGTACAAGTAAACGC
AACTGGTAGACACGAC-1	AATTGGCTTC	--------GACGAGCTGTACAAGTAAACGC
AGTGAGGGTTGGTTTG-1	AATTGTCTGG	TCGGCATGGACGAGCTGTACAAGTAAACGC
CAGAGAGGTGAGGCTA-1	AATTGTTGTG	TCGGCATGGACGAGCTGTACAAGTAAACGC
GGACAGACAACGCACC-1	AATTGTTTTT	TCGGCATGGACGAGCTGTACAAGTAAACGC
ATGCGATGTCAGTGGA-1	AATTTAATAA	------------------------------
AGAATAGTCCTTGGTC-1	AATTTCACTC	TCGGCATGGACGAGCTGTACAAGTAAACGC
CGAGCACGTCCGAGTC-1	AATTTCTTCG	------------------------------
CGTTCTGTCAGGTAAA-1	AATTTGGGTA	TCGGCATGGACGAGCTGTACAAGTAAACGC
CAGCATAGTGACTCAT-1	AATTTGTATC	TCGGCATGGACGAGCTGTACAAGTAAACGC
CGCGGTAAGATGTCGG-1	AATTTTAGCC	TCGGCATGGACGAGCTGTACAAGTAAACGC
CTCGAAAGTCCAGTGC-1	ACAAAAAATA	---GCATGGACGAGCTGTACAAGTAAACGC
CAAGATCAGATCTGCT-1	ACAAATAGCA	TCGGCATGGACGAGCTGTACAAGTAAACGC
GACCAATGTGGTAACG-1	ACAAATGAAA	TCGGCATGGACGA-----------------
TGAAAGAAGCACGCCT-1	ACAAATGGGT	------------------------------
TGAAAGAAGCACGCCT-1	ACAAATGGGT	----------------------------GC
GACGTGCGTACCGGCT-1	ACAACAGTTT	TCGGCATGGACGAGCTGTACAAGTAAACGC
TTGGAACTCACATACG-1	ACAACTATGC	TCGGCATGGACGAGCTGTACAAGTAAACGC
AACTCAGCAACACGCC-1	ACAACTCAGA	TCGGCATGGACGAGCTGTACAAGTAA----
TGTATTCCATCTGGTA-1	ACAACTCCTC	TC----------------------------
TGCGCAGCATTCGACA-1	ACAAGAAAGT	------------------------------
CGCGGTATCCATGAAC-1	ACAAGCTACA	TCGGCATGGACGAGCTGTACAAGTAAACGC
TTAGGACTCTTTACAC-1	ACAAGCTCTT	TCGGCATGGACGAGCTGTACAAGTAAACGC
CTTAACTAGCGTTCCG-1	ACAAGTTCGT	TCGGCATGGACGAGCTGTACAAGTAAACGC
TACCTTACATCCTAGA-1	ACAATCGGAC	TCGGCATGGACGAGCTGTACAAGTAAACGC
AACTTTCGTAGAAAGG-1	ACACAAATTT	TCGGCATGGACGAGCTGTACAGGTAAACGC
GGACAGAAGAGGTTAT-1	ACACAATTTT	TCGGCATGGACGAGCTGTACAAGTAAACGC
CGCTGGAAGACAAAGG-1	ACACAGCTAA	--GGCATGGACGAGCTGTACAAGTAAACGC
CGTCTACGTTGGACCC-1	ACACATCGCC	TCGGCATGGACGAGCTGTACAAGTAAACGC
CTCAGAATCGACCAGC-1	ACACCGCTCC	TCGGCATGGACGAGCTGTACAAGTAAACGC
TTCTCAAAGGGCACTA-1	ACACCGGAAT	TCGGCATGGACGAGCTGTACAAGTAAACGC
ACGGGTCCATTTCACT-1	ACACGTACCC	TCGGCATGGACGAGCTGTACAAGTAAACGC
TGACAACAGGGTCGAT-1	ACACTCCTTG	TCGGCATGGACGAGCTGTACAAGTAAACGC
GCCAAATAGCCGGTAA-1	ACACTCTGCT	------------------------------
GATGCTATCGCCAAAT-1	ACACTGTTTT	TCGGCATGGACGAGCTGTACAAGTAAACGC
GTCCTCAGTCACCCAG-1	ACACTTACCG	------------------------------
GATGCTATCGCCAAAT-1	ACAGACAACC	TCGGCATGGACGAGCTGTACAAGTAAACGC
CTGATAGGTAAGTGGC-1	ACAGAGCCTT	TCGGCATGGACGAGCTGTACAAGTAAACGC
AACCGCGAGTGTCCAT-1	ACAGCAACCA	TCGGCATGGACGAGCTGTACAAGTAAACGC
TAGTGGTCACGTGAGA-1	ACAGGGGCAA	------------AGCTGTACAAGTAAACGC
AACTCAGCAACACGCC-1	ACAGTTCCTT	------------------------------
AACTGGTAGTGCGTGA-1	ACAGTTTGAC	TCGGCATGGACGAGCTGTACAAGTAAACGC
CATGACAAGTAGCCGA-1	ACATAAACGT	------------------------------
CTCAGAACAGTATCTG-1	ACATAACAGG	---------ACGAGCTGTACAAGTAAACGC
TGAAAGACACGGCCAT-1	ACATACGACG	TCGGCATGGACGAGCTGTACAAGTAAACGC
AATCCAGCATGTCCTC-1	ACATACGCTG	TCGGCATGGACGAGCTGTACAAGTAAACGC
GCGAGAAGTACTCTCC-1	ACATACGTCC	TCGGCATGGACGAGCTGTACAAGTAAACGC
AGTGAGGAGAGGTACC-1	ACATAGCGGA	---------ACGAGCTGTACAAGTAAACGC
ACTATCTTCCGTTGTC-1	ACATCTAATT	TCGGCATGGACGAGCTGTACAAG-------
TTGGCAAGTTAGAACA-1	ACATGATTAT	TCGGCATGGACGAGCTGTACAAGTAAACGC
CATCAGAAGACCTTTG-1	ACATGGTGCG	------------------------------
CATGACAAGTAGCCGA-1	ACATGGTGTT	------------------------------
AGTTGGTCAAGCTGAG-1	ACATGTCGTC	-------------------CAAGTAAACGC
ACCCACTGTGTGACCC-1	ACATTAGTTT	TCGGCATGGACGAGCTGTACAAGTAAACGC
CTCACACGTACTTAGC-1	ACATTATCGT	---------ACGAGCTGTACAAGTAAACGC
TAGGCATTCGTTTATC-1	ACATTCGAGT	------------------------------
AACTGGTAGATAGCAT-1	ACATTTGGTG	TCGGCATGGACGAGCTGTACAAGTAAACGC
TCCCGATCAGTCGATT-1	ACCACGGGTT	TCGGCATGGACGAGCTGTACAAGTAAACGC
GCTCCTAAGACCTTTG-1	ACCACGTTTC	TCGGCATGGACGAGCTGTACAAGTAAACGC
CCGTTCAAGCTAAGAT-1	ACCAGGGTTT	TCGGCATGGACGAGCTGTACAAGTAAACGC
CTCGTACAGAACAATC-1	ACCCAAGTTG	-----------GAGCTGTACAAGTAAACGC
GGAACTTTCGTACGGC-1	ACCCAGGTAT	------------------------------
ACGTCAAAGTTACCCA-1	ACCCATATCG	TCGGCATGGACGAG----------------
TTTCCTCTCGCTTAGA-1	ACCCGAAGCT	-------------GCTGTACAAGTAAACGC
CTTAACTCAAACCCAT-1	ACCCGGACGT	TCGGCATGGA--------------------
GGTGCGTGTCAGAAGC-1	ACCCGTATTG	TCGGCATGGACGAGCTGTACAAGTAAACGC
ACAGCCGCAGAGTGTG-1	ACCCGTTGGT	TCGGCATGGACGAGCTGTACAAGTAAACGC
AAGGCAGGTTCGCGAC-1	ACCCTAATTC	------------------------------
GATGAAAGTGAAATCA-1	ACCGAAAAGC	TCGGCATGGACGAGCTGTACAAGTAAACGC
TAGTGGTCACGTGAGA-1	ACCGAATGGG	TCGGCATGGACGAGCTGTACAAGTAAACGC
AGACGTTGTGATGTGG-1	ACCGACTCGC	TCGGCATGGACGAGCTGTACAAGTAAACGC
GCACTCTGTACCGGCT-1	ACCGCATCAC	TCGGCATGG---------------------
TGCTACCCAATGGACG-1	ACCGCGTAAC	TCGGCATGGACGAGCTGTACAAGTAAACGC
ACTGTCCGTGTAAGTA-1	ACCGGAAAGC	TCGGCATGGACGAGCTGTACAAGTAAACGC
TAGCCGGGTCTGCCAG-1	ACCGGCCTGA	------------------------------
CAAGGCCAGACACGAC-1	ACCGGTGGTC	-----------GAGCTGTACAAGTAAACGC
GTTACAGCACATCCAA-1	ACCGGTTTTT	------------------------------
TTTGCGCCACCGAATT-1	ACCGTCAAAG	---------------------------CGC
CGTAGGCCAGTCGTGC-1	ACCGTCCTGT	----------------GTACAAGTAAACGC
GATCAGTCATTCTTAC-1	ACCTACCTCG	TCGGCATGGACGAGCTGTACAAGTAAACGC
CACCTTGGTTAGATGA-1	ACCTACCTCT	TCGGCATGGACGAGCTGTACAAGTAAACGC
GACCAATGTGGTAACG-1	ACCTATTATA	------------------------------
GCGCGATGTAGCTAAA-1	ACCTCAGTTC	TCGGCATGGACGAGCTGTACAAGTAAACGC
GACACGCGTTTCCACC-1	ACCTCTCGCG	TCGGCATGGACGAGCTGTACAAGTAAACGC
TACCTTAAGTACGCGA-1	ACCTGACATC	TCGGCATGGACGAGCTGTACAAGTAAACGC
GGTGCGTCACTGTCGG-1	ACCTGGAACA	TCGGCATGGACGAGCTGTACAAGTAAACGC
GCGCCAAAGACTAGGC-1	ACCTTCACCA	TCGG--------------------------
AACGTTGCATGATCCA-1	ACCTTTCTCG	TCGGCATGGACGAGCTGTACAAGTAAACGC
GAGGTGACAGATGGCA-1	ACCTTTGCGC	TCGGCATGGACGAGCTGTACAAGTAAACGC
AATCCAGTCTGCCAGG-1	ACGAAGTGCG	TCGGCATGGACGAGCTGTACAAGTAAACGC
AGCGGTCCACTTAAGC-1	ACGAATTTTC	TCGGCATGGACGAGCTGTACAAGTAAACGC
GCTGCGACATACCATG-1	ACGAGTTAGT	TCGGCATGGACGAGCTGTACAAGTAAACGC
CGCGGTAAGATGTCGG-1	ACGATCCAGG	TCGGCATGGACGAGCTGTACAAGTAAACGC
TTGCCGTAGAGTTGGC-1	ACGATCCCCA	TCGGCATGGACGAGCTGTACAAGTAAACGC
CTGCCTATCTACTATC-1	ACGATCGGAC	TCGGCATGGACGAGCTGTACAAGTAAACGC
CTGCTGTGTTAAAGAC-1	ACGATTGGCG	TCGGCATGGACGAGCTGTACAAGTAAACGC
CGCGGTATCCATGAAC-1	ACGCAAAGGG	------------------------------
CCCAGTTGTCAGAAGC-1	ACGCAAGCCT	---TCGGCATGGACGAGCTGTACAAGTAAA
AAGGAGCTCAGTCCCT-1	ACGCACGAGA	TCGGCATGGACGAGCTGTACAAGTAAACGC
GGACAGAAGAACTCGG-1	ACGCAGCCTG	------------------------------
CCCTCCTCACGGTGTC-1	ACGCATCCTC	TCGGCATGGACGAGCTGTACAAGTAAACGC
TGAGAGGAGAGGACGG-1	ACGCATGGCC	TCGGCATGGACGAGCTGTACAAGTAAACGC
ATGCGATGTCTTCAAG-1	ACGCATGTGA	TCGGCATGGACGAGCTGTACAAGTAAACGC
TCCACACCAAGGTTCT-1	ACGCATTCAT	TCGGCATGGACGAGCTGTACAAGTAAACGC
CCGTGGAAGGGAGTAA-1	ACGCCAGACG	----------CGAGCTGCACAAGTAAACGC
TCAGATGTCGCTTGTC-1	ACGCCAGGAT	--------------------AAGTAAACGC
GATTCAGCAGGGTACA-1	ACGCCCACTG	------------------------------
ACTGTCCGTGTAAGTA-1	ACGCCGCCGA	TCGGCATGGACGAGCTGTACAAGTAAACGC
CATCAGAAGGGTATCG-1	ACGCGCCGTC	---------------TCGGCATGGACGAGC
AACACGTAGACTCGGA-1	ACGCTTAAAA	TCGGCATGGACGAGCTGTACAAGTAAACGC
AGGGAGTCAAGCCATT-1	ACGGAGTTTT	------------------------------
CTGATCCTCCACTGGG-1	ACGGATTTTG	------------------------------
AAGCCGCCATAGACTC-1	ACGTAGATGT	TCGGCATGGACGAGCTGTACAAGTAAACGC
ACATACGAGGCCCTCA-1	ACGTATCCAG	TCGGCATGGACGAGCTGTACAAGTAAACGC
CTACACCAGCGATCCC-1	ACGTATTTAT	TCGGCATGGACGAGCTGTACAAGTAAACGC
CAAGTTGGTTCACCTC-1	ACGTCCGGAT	TCGGCATGGACGAGCTGTACAAGTAAACGC
TTAACTCAGCTCTCGG-1	ACGTCGATGG	TCGGCATGGACGAGCTGTACAAGTAAACGC
TGAGCATCATGGTCAT-1	ACGTCGTCTC	TCAGCATGGACGAGCTGTACAAGTAAACGC
CGAACATAGAAACGAG-1	ACGTCTATGC	TCGGCATGGACGAGCTGTACAAGTAAACGC
TGTATTCGTATATGAG-1	ACGTCTGGCA	TCGGCATGGACGAGCTGTACAAGTAAACGC
CGCTTCAGTATTAGCC-1	ACGTGATAGG	------------------------------
GTGTTAGCAGTAAGAT-1	ACGTGCCCTT	TCGGCATGGACGAGCTGTACAAGTAAACGC
GATGAGGCATAGGATA-1	ACGTGGTTCT	TCGGCATGGACGAGCTGTACAAGTAAACGC
GGCAATTCAGCAGTTT-1	ACGTTAGTCT	TCGGCATGGACGAGCTGTACAAGTAAACGC
GTGCATAGTTCAGTAC-1	ACGTTATACT	TCGGCATGGACGAGCTGTACAAGTAAACGC
GACGCGTAGCAGCCTC-1	ACGTTGAAGG	------------------------------
CCGGTAGAGAGCCCAA-1	ACGTTTTTGA	TCGGCATGGACGAGCTGTACAAGTAAACGC
CGCTTCAGTGCAGTAG-1	ACTAACTTGA	TCGGCATGGACGAGCTGTACAAGTAAACG-
GAACCTAAGCTAGTCT-1	ACTAACTTGA	TCGGCATGGACGAGCTGTACAAGTAAACGC
TCATTTGGTCAGCTAT-1	ACTACACTCA	------------------------------
TTGACTTTCCTGTAGA-1	ACTACGACAC	------------------------------
CGATGTAGTGCAGTAG-1	ACTAGATACA	------------AGCTGTACAAGTAAACGC
CACACAATCGTCTGCT-1	ACTAGGGCCA	TCGGCATGGACGAGCTGTACAAGTAAACGC
AGCTCCTTCACGCATA-1	ACTATAGGTA	TCGGCATG----------------------
GCAATCACATTAACCG-1	ACTATCACAC	TCGGCATGGACGAGCTGTACAAGTAAACGC
TACTCATCATGCGCAC-1	ACTATCGGCG	TCGGCATGGACGAGCTGTACAAGTAAACGC
CGATGGCCACAGACAG-1	ACTATCGGTT	------------AGCTGTACAAGTAAACGC
ACGCAGCTCAAACGGG-1	ACTATGCGAT	TCGGCATGGACGAGCTGTACAAGTAAACGC
CACATAGTCGTTACAG-1	ACTCAGCGTA	------------------------------
CAAGTTGGTTAGGGTG-1	ACTCAGGGCC	TCGGCATGGACGAGCTGTACAAGTAAACGC
GAATGAAAGCGAAGGG-1	ACTCCCTACA	------------------------------
CCTACCAGTGAGGCTA-1	ACTCGAGTAT	----------------------GTAAACGC
AACACGTAGATGGCGT-1	ACTCGATTAC	TCGGCATGGACGAGCTGTACAAGTAAACGC
GACGCGTGTCTAGCCG-1	ACTCTGGTGT	TCGGCATGGACGAGCTGTACAAGTAAACGC
CTGTGCTTCTGGTATG-1	ACTGAATTGA	TCGGCATGGACGAGCTGTACAAGTAAACGC
GCATGCGCAACTTGAC-1	ACTGGGCCGT	TCGGCATGGACGAGCTGTACAAGTAAACGC
AAGGCAGTCGGAGCAA-1	ACTGGTTGCA	TCGGCATGGACGAGCTGTACAAGTAAACGC
GCAGTTAGTCATTAGC-1	ACTGTAATCG	TCGGCATGGACGAGCTGTACAAGTAAACGC
GAATGAATCAGTACGT-1	ACTGTAGCTT	---GCATGGACGAGCTGTACAAGTAAACGC
ATGAGGGTCCAACCAA-1	ACTGTCGTAT	TCGGCATGGACGAGCTGTACAAGTAAACGC
TCTCATAAGAGTAATC-1	ACTGTCTAAC	TCGGCATGGACGAGCTGTACAAGTAAACGC
ATGAGGGTCGGAGCAA-1	ACTGTGGTAT	TCGGCATGGACGAGCTGTACAAGTAAACGC
TGTATTCTCACCATAG-1	ACTTACGGCC	TCGGCATGGACGAGCTGTACAGGTAAACGC
CAACTAGAGCTGCCCA-1	ACTTCCAGTA	TCGGCATGGACGAGCTGTACAAGTAAACGC
CCACTACTCGGCGGTT-1	ACTTCCGTGG	TCGGCATGGACGAGCTGTACAAGTAAACGC
AGTAGTCCAGCTCGAC-1	ACTTCCTTAT	------------------------------
GTAACGTCAATGGAGC-1	ACTTGTAGGT	TCGGCATGGACGAGCTGTACAAGTAAACGC
CGATGTAAGATCCTGT-1	ACTTGTCGTC	TCGGCATGGACGAGCTGTACAAGTAAACGC
TATTACCCACGCCAGT-1	ACTTTATACT	TCGGCATGGACGAGCTGTACAAGTAAACGC
TGACAACAGGGTCGAT-1	ACTTTCCACA	TCGGCATGGACGAGCTGTACAAGTAAACGC
CGCTTCATCCAGAGGA-1	ACTTTCGCAG	----------------GTACAAGTAAACGC
TACGGATAGCTAAACA-1	ACTTTCGGAA	------------------------------
GGAAAGCAGAACAATC-1	ACTTTTTCAT	TCGGCATGGACGAGCTGTACAAGTAAACGC
CGCGTTTGTCCGAGTC-1	AGAACAAATA	------------------------------
AAGGTTCTCTGCAAGT-1	AGAACAAATC	TCGGCATGGACGAGCTGTACAAGTAAACGC
TACTCATAGCAGACTG-1	AGAACTGTCT	TCGGCATGGACGAGCTGTACAAGTAAACGC
TGACTTTTCAACACCA-1	AGAATATTAG	------------------------------
TGGGAAGAGCGGATCA-1	AGAATATTAG	TCGGCATGGACGAGCTGTACAAGTAAACGC
GGATGTTGTCCAGTGC-1	AGACACGAAT	------------AGCTGTACAAGTAAACGC
CTAATGGCATTTGCCC-1	AGACAGCGTT	TCGGCATGGACGAGCTGTACAAGTAAACGC
TGGGAAGGTGGCTCCA-1	AGACCCTGCA	TCGGCATGGACGAGCTGTACAAGTAAACGC
TCTTTCCTCTGGCGTG-1	AGACTGACTA	------------------------------
CATCGAAAGGTAAACT-1	AGACTTTCCA	---------------------AGTAAACGC
AGTGAGGCAGTAAGAT-1	AGAGATACCT	TCGGCATGGACGAGCTGTACAAGTAAACGC
ACATCAGCAAGAGTCG-1	AGAGCTAGGT	TCGGCATGGACGAGCTGTACAAGTAAACGC
GTGCTTCAGGGTTCCC-1	AGAGGTTGGT	---GCATGGACGAGCTGTACAAGTAAACGC
CGGACGTCACGCCAGT-1	AGAGTATTCC	TCGGCATGGACGAGCTGTACAAGTAAACGC
GTTCATTTCCAAAGTC-1	AGAGTCGCCA	TCGGCATGGACGAGCTGTACAAGTAAACGC
AAGGAGCTCATGTGGT-1	AGAGTGGGGG	TCGGCATGGACGAGCTGTACAAGTAAACGC
GAATGAACAGTACACT-1	AGATAATAGG	------------------------------
AAAGATGAGACACTAA-1	AGATACGTTC	--------GACGAGCTGCACAAGTAAACGC
CTTCTCTTCATAACCG-1	AGATCGTTTT	TCGGCATGGACGAGCTGTACAAGTAAACGC
TACTCATGTAGCCTAT-1	AGATCTCGGT	TCGGCATGGACGAGCTGTACAAGTAAACGC
CTGCTGTGTTAAAGAC-1	AGATTATTCA	TCGGCATGGACGAGCTGTACAAGTAAACGC
TGCGGGTTCCACGAAT-1	AGATTGTTAA	------------------------------
AGTAGTCCAGCCTTTC-1	AGATTTAAAT	TCGGCATGGACGAGCTGTACAAGTAAACGC
GCATGCGAGCCAGTAG-1	AGCAACTAGT	---GCATGGACGAGCTGTACAAGTAAACGC
GGGAGATTCTGTCTAT-1	AGCAATGCCT	TCGGCATGGACGAGCTGTACAAGTAAACGC
CGAGAAGTCCCTGACT-1	AGCAATTCTC	TCGGCATGGTCGAG----------------
GATGAGGGTTGATTGC-1	AGCACCGTTA	TCGGCATGGACGAGCTGTACAAGTACACGC
CTAATGGCAGCGAACA-1	AGCAGGTCAT	TCGGCATGGACGAGCTGTACAAGTAAACGC
CACATAGAGATCTGAA-1	AGCAGTTCTG	------------------------------
CGAATGTCACTGTCGG-1	AGCATCTAAA	TCGGCATGGACGAGCTGTACAAGTAAACGC
TAGTTGGGTCACCTAA-1	AGCATTGTCC	------------------------------
CCGTACTGTAAAGGAG-1	AGCCACTTAG	TCGGCATGGACGAGCTGTACAAGTAAACGC
TTGCCGTGTTATCACG-1	AGCCAGGTTA	------------------------------
ACTTGTTGTCTAGTCA-1	AGCCATCGTA	------TGGACGAGCTGTACAAGTAAACGC
GTGGGTCAGGAGTTGC-1	AGCCATGAAT	------------------------------
CAGCTAATCTGGCGAC-1	AGCCGAACTG	TCGGCATGGACGAGCTGTACAAGTAAACGC
GCTTCCAGTGTGAAAT-1	AGCCGCTACG	T-----------------------------
TCGCGAGTCCTTAATC-1	AGCCGCTCCG	TCGGCATGGACGAGCTGTACAAGTAAACGC
AGATTGCCACAGCCCA-1	AGCCGGCAGC	TCGGCATGGACGAGCTGTACAAGTAAACGC
ATTCTACGTCCATGAT-1	AGCCGGTTGA	TCGGCATGGACGAGCTGTACAAGTAAACGC
CCATGTCGTCGCGGTT-1	AGCCTAGTCT	TCGGCATGGACGAGCTGTACAAGTAAACGC
CGTTCTGGTGCCTTGG-1	AGCCTCAAAT	TCGGCATGGACGAGCTGTACAAGTAAACGC
CTGGTCTCATAAGACA-1	AGCCTGGAAT	------------------------------
CTAGTGAAGAGGTTAT-1	AGCCTGTGAG	TCGGCATGGACGAGCTGTACAAGTAAACGC
GCCAAATTCCCATTAT-1	AGCGAAACAT	TCGGCATGGACGAGCTGTACAAGTAAACGC
TGTCCCACAGCCTATA-1	AGCGATTGCG	TCGGCATGGACGAGCTGTACAAGTAAACGC
TTGCGTCGTGGAAAGA-1	AGCGCAGAGT	------------------------------
GAGCAGATCTGCTGCT-1	AGCGCCTGGC	------------------------------
TACAGTGAGTGGCACA-1	AGCGTTAGGC	TCGGCATGGACGAGCTGTACAAGTAAACGC
GTTACAGTCCGATATG-1	AGCTAAATAC	TCGGCATGGACGAGCTGTACAAGTAAACGC
CCGTACTGTGCAACTT-1	AGCTACCGCC	TCGGCATGGACGAGCTGTACAAGTAAACGC
TTGTAGGAGATATGCA-1	AGCTATGTAC	------------------------------
CTGTGCTCACCGAAAG-1	AGCTCATCAC	TCGGCATGGACGAGCTGTACAAGTAAACGC
GGGAGATAGATGGCGT-1	AGCTCGCGGC	-------------------CAAGTAAACGC
TACGGATGTCGAATCT-1	AGCTCGCGTA	------------------------------
TGGCCAGTCGTATCAG-1	AGCTGCAAGC	TCGGCATGGACGAGCTGTACAAGTAAACGC
TCGCGAGAGTGTCCAT-1	AGCTGCCGGA	TCGGCATGGACGAGCTGTACAAGTAAACGC
CTCGGGAAGACCGGAT-1	AGCTGCGACC	TCGGCATGGACGAGCTGTACAAGTAAACGC
CAGATCACACGTGAGA-1	AGCTGGGAGC	TCGGCATGGACGAGCTGTACAAGTAAACGC
CGGACACAGGACACCA-1	AGCTTAAGGG	------------------------------
TGTATTCGTGCTAGCC-1	AGCTTGCAAT	------------------------------
AACACGTGTGCACTTA-1	AGCTTTGCCG	TCGGCATGGACGAGCTGTACAAGTAAACGC
CGGCTAGAGCTGTTCA-1	AGGAAGATAA	TCGGCATGGACGAGCTGTACAAGTAAACGC
CGCTGGAGTTTGTTGG-1	AGGACATGGG	TCGGCATGGACGAGCTGTACAAGTAAACGC
GGACAGACAATCCGAT-1	AGGACCGTGC	TCGGCATGGACGAGCTGTACAAGTAAACGC
GTATTCTCATACTACG-1	AGGAGAATTG	TCGGCATGGACGAGCTGTACAAGTAAACGC
GGGCATCGTCGTGGCT-1	AGGAGGGGTT	----------------------GTAAACGC
GACTGCGAGGATGCGT-1	AGGATCGTTT	TCGGCATGGACG------------------
TCGCGAGTCAGGCAAG-1	AGGATGCTGT	TCGGCATGGACGAGCTGTACAAGTAAACGC
CTCCTAGAGGCTAGCA-1	AGGATGGTTG	------------------------------
ACCTTTACAACTTGAC-1	AGGCAGCCAG	TCGGCATGGACGAGCTGTACAAGTAAACGC
ACGAGCCCAAACCCAT-1	AGGCATATAG	------------------------------
CGGACACAGGACACCA-1	AGGCCCGACC	TCGGCATGGACTAGCTGTACAAGTAAACGC
GGGCATCGTAAACACA-1	AGGCCTACTT	------------------------------
GTACTCCCAGTTTACG-1	AGGCTCTTTT	---GCATGGACGAGCTGTACAAGTAAACGC
GACAGAGTCAAACCAC-1	AGGCTGCTGC	------------------------------
GACGTTAAGGTAGCCA-1	AGGGGACACG	TCGGCATGGACGAGCTGTACAACTAAACGC
CTCTACGGTTCCACAA-1	AGGGTCCTCA	------------------------------
GCTGGGTTCAACGGGA-1	AGGGTCGACA	TCGGCATGGACGAGCTGTACAAGTAAACGC
TGGTTCCCACAGCCCA-1	AGGTCATTTT	------------AGCTGTACAAGTAAACGC
ATCCGAACAGGGTTAG-1	AGGTCCAGCA	TCGGCATGGACGAGCTGTACAAGTAAACGC
GCAGCCATCTAACGGT-1	AGGTTCCTTT	TCGGCATGGACGAGCTGTACAAGTAAACGC
CAGCATATCGCAAACT-1	AGGTTCGTGC	------------------------------
AACACGTGTGCACTTA-1	AGGTTTTTCA	TCGGCATGGACGAGCTGTACAAGTAAACGC
CGGACTGAGAAACGAG-1	AGTAAAACTT	TCGGCATGGACGAGCTGTACAAGTAAACGC
AGGGATGAGGCTAGAC-1	AGTACAATTG	------------------------------
TGCGCAGTCTAACTGG-1	AGTACTCGCT	------------AGCTGTACAAGTAAACGC
AGCAGCCTCCAGAGGA-1	AGTAGTAGTT	TCGGCATGGACGAGCTGTACAAGTAAACGC
CATGGCGAGTGGTAAT-1	AGTATCTCGT	------------------------------
CAGCTAATCTGGCGAC-1	AGTATTTCGG	TCGGCATGGACGAGCTGTACAAGTAAACGC
CTACACCCAGACGCAA-1	AGTCAAGTTA	TCGGCATGGACGAGCTGTACAAGTAAACGC
TGTGTTTAGACAGGCT-1	AGTCACGAAG	TCGGCATGGACGAGCTGTACAAGTAAACGC
AGTGGGAGTAAGGGCT-1	AGTCATCCCA	-----ATGGACGAGCTGTACAAGTAAACGC
CATCGAAGTCTCATCC-1	AGTCCATATC	TCGGCATGGACGAGCTGTACAAGTAAACGC
TGATTTCGTTAAGTAG-1	AGTCCATGAC	TC----------------------------
ATCACGACAATACGCT-1	AGTCCTGGGT	TCGGCATGGACGAGCTGTACAAGTAAACGC
ACGATACCAAACTGCT-1	AGTCGCCCGT	TCGGCATGGACGAGCTGTACAAGTAAACGC
CGTCAGGTCAGCTCTC-1	AGTCTCTTGA	TCGGCATGGACGAGCTGTACAAGTAAACGC
ACGCAGCTCAAACGGG-1	AGTCTGCGGC	------------------------------
CGCTATCGTTACGGAG-1	AGTGAAGCTT	TCGGCATGGACGAGCTGTACAAGTAAACGC
GCATGCGCATCTGGTA-1	AGTGATTTAT	------------------------------
ATCCGAACAGGGTTAG-1	AGTGCGACCT	TCGGCATGGACGAGCTGTACAAGTAAACGC
GACGGCTGTATCTGCA-1	AGTGGAGTCG	TCGGCATGGACGAGCTGTACAAGTAAACGC
TGTCCCAGTCTTGTCC-1	AGTGGCCCTT	TCGGCATGGACGAGCTGTACAAGTAAACGC
CTCGTCATCCCATTAT-1	AGTGGGCATA	TCGGCATGGACGAGCTGTACAAGTAAACGC
TTTGCGCTCCGGGTGT-1	AGTTAAATTC	TCGGCATGGACGAGCTGTACAAGTAAACGC
ACGTCAACAGACGCTC-1	AGTTAAGTTG	TCGGCATGGACGAGCTGTACAAGTAAACGC
TCCACACCAAATCCGT-1	AGTTATGTCC	TCGGCATGGACGAGCTGTACAAGTAAACGC
AAATGCCAGGACATTA-1	AGTTCAACGT	TCGGCATGGACGAGCTGTACAAGTAAACGC
GATCGTATCACTATTC-1	AGTTCCGTAT	TCGGCATGGACGAGCTGTACAAGTAAACGC
AAAGCAAGTAGCGTAG-1	AGTTCTATGA	------------------------------
GTACTCCAGAGGTTAT-1	AGTTGGATCA	------------------------------
CTAGCCTTCCAAACTG-1	AGTTGGTTTC	TCGGCATGGACGAGCTG-------------
AGGGTGACAGATGGGT-1	AGTTTCCCTA	TCGGCATGGACGAGCTGTACAAGTAAACGC
CACCAGGCAGCATACT-1	AGTTTCTTTA	TCGGCATGGACGAGCTGTACAAGTAAACGC
TGGTTCCCACACAGAG-1	AGTTTCTTTT	TCGGCATGGACGAGCTGTACAAGTAAACGC
ACGCCGATCAACGAAA-1	AGTTTGGCGC	TCGGCATGGACGAGCTGTACAAGTAAACGC
CGAATGTTCAACCAAC-1	AGTTTTATGC	------------------ACAAGTAAACGC
TTTACTGCAACTGCTA-1	AGTTTTTTTA	TCGGCATGGACGAGCTGTACAAGTAAACGC
CCTACACCAGCTGGCT-1	ATAACTACCT	TCGGCATGGACGAGCTGTACAAGTAAACGC
GTACGTATCACGCATA-1	ATAACTCTGG	------------------------------
ACTATCTGTTGTCTTT-1	ATAACTGCTT	TCGGCATGGACGAGCTGTACAAGTAAACGC
AACTGGTGTTCACCTC-1	ATAACTTTAG	TCGGCATGGACGAGCTGTACAAGTAAACGC
CACACAACACGTTGGC-1	ATAAGAGGTC	TCGGCATGGACGAGCTGTACAAGTAAACGC
CACCTTGCAAATTGCC-1	ATAAGTTTTT	TCGGC-------------------------
GGCCGATAGCGTGAAC-1	ATAATAAATC	TCGGCATGGACGAGCTGTACAAGTAAACGC
GTACTCCAGAGGTTAT-1	ATAATACTGC	------------AGCTGTACAAGTAAACGC
CGGAGCTAGAGGTTAT-1	ATAATGATGG	TCGACATGGACGAGGTGTACAAGTAAACGC
CACCACTGTCTTCAAG-1	ATAATGTCTG	----------------------GTAAACGC
ACGCCAGCACAGAGGT-1	ATAATTGTGT	TCGGCATGGACGAGCTGTACAAGTAAACGC
CGGAGCTTCCCGGATG-1	ATAATTTTAT	------------------------------
CGCTGGAGTCAGTGGA-1	ATACCAAGGT	TCGGCATGGACGAGCTGTACAAGTAAACGC
AGCGGTCGTAGATTAG-1	ATACCGTTCG	TCGGCATGGACGAGCTGTACAAGTAAACGC
GTTCTCGCATTGAGCT-1	ATACGAAGCA	TCGGCATGGACGAGCTGTACAAGTAAACGC
CAGATCAGTTATCACG-1	ATACGAGTTA	TCGGCATGGACGAGCTGTACAAGTAAACGC
TCGAGGCGTTCTGTTT-1	ATACGCTTTT	------------------------------
CAAGTTGCACCGAAAG-1	ATACGGCATG	-------GGACGAGCTGTACAAGTAAACGC
TGGCGCATCTGCGTAA-1	ATACGTCTTT	------TGGACAAGCTGTACAAGTAAACGC
GTCTCGTTCCCAAGTA-1	ATACGTTGTG	------------------------------
CTCCTAGGTTGTGGAG-1	ATACTAATTG	TCGGCATGGACGAGCTGTACAAGTAAACGC
CACCAGGCATAAAGGT-1	ATACTATCTT	------------------------------
TCGTAGAAGCACCGCT-1	ATACTGGTTG	------------------------------
GCGACCATCTCTAGGA-1	ATACTGTCAG	----------------------GTAAACGC
ACCAGTAAGCTCAACT-1	ATACTGTGTA	TCGGCATGGACGAGCTGTACAAGTAAACGC
ACTTTCACAGGGTACA-1	ATAGAGTTTA	------------------------------
CTCGAGGGTCGTCTTC-1	ATAGCTTCTC	TCGGCATGGACGAGCTGTACAAGTAAACGC
TTCCCAGTCTATCCCG-1	ATAGCTTTTT	----------------GTACAAGTAAACGC
ATGGGAGCACATCCAA-1	ATAGGACTTG	TCGGCATGGACGAGCTGTACAAGTAAACGC
TGTGGTAGTGTGACGA-1	ATAGGATTCC	TCGGCATGGACGAGCTGTACAAGTAAACGC
ACGAGGAAGGCTACGA-1	ATAGGATTGT	TCGGCATGGACGAGCTGTACAAGTAAACGC
ATCCGAAGTGTTTGGT-1	ATAGGCTGTA	TCGGTATGGACGAGCTGTACAAGTAAACGC
CGTCTACAGGGTCGAT-1	ATAGTACATT	TCGGCATGGACGAGCTGTACAAGTAAACGC
AGGGAGTAGTGGTAGC-1	ATAGTCAGGG	TCGGCATGGACGAG----------------
GGCAATTGTTGTACAC-1	ATAGTCATCT	TCGGCATGGACGAGCTGTACAAGTAAACGC
CACATTTCAAGGGTCA-1	ATAGTGTGGG	TCGGCATGGACGAGCTGTACAAGTAAACGC
CTGAAACGTTTGACTG-1	ATAGTGTTTT	TCGGCATGGACGAGCTGTACAAGTAAACGC
GACAGAGGTCTAGAGG-1	ATAGTTGCCA	TCGGCATGGACGAGCTGTACAAGTAAACGC
CCCAATCTCCTTGGTC-1	ATAGTTGGCA	TCGGCATGGACGAGCTGTACAAGTAAACGC
CACAGTAAGAGAACAG-1	ATAGTTTTTG	TCGGCATGGACGAGCTGTACAAGTAAACGC
GTGCTTCTCCCATTTA-1	ATATACGAGA	TCGGCATGGACGAGCTGTACAAGTAAACGC
GGACAGACAACGCACC-1	ATATACTATG	------------------------------
GCGCAGTAGAAGGTTT-1	ATATCAAACG	TCGGCATGGACGAGCTGTACAAGTAAACGC
TACTCATAGCTGATAA-1	ATATCCAGGA	TCGGCATGGACGAGCTGTACAAGTAAACGC
ACATGGTAGAGGTACC-1	ATATGAAATT	TCGGCATGGACGAGCTGTACAAGTAAACGC
TACTTGTGTGCAACGA-1	ATATGCGATC	TCGGCATGGACGAGCTGTACAAGTAAACGC
GGCAATTGTACAGTGG-1	ATATGTAATA	TCGGCATGGACGAGCTGTACAAGTAA----
GATGAGGCATAGGATA-1	ATATGTGTGT	TCGGCATGGACGAGCTGTACAAGTAAACGC
CGGACTGAGAAACGAG-1	ATATGTTGTT	TCGGCATGGACGAGCTGTACAAGTAAACGC
TTGGAACTCCTATTCA-1	ATATTAACGG	TCGGCATGGACGAGCTGTACAAGTAAACGC
GCTGCGAGTCTCTTAT-1	ATATTACTGT	TCGGCATGGACGAGCTGTACAAGTAAACGC
GTGAAGGCAGGGCATA-1	ATATTCGCCG	------------------------------
GTATTCTAGACAAGCC-1	ATCACCGTAG	TCGGCATGGACGAGCTGTACAAGTAAACGC
CGCGGTAGTGCCTGTG-1	ATCACCGTTG	TCGGCATGGACGAGCTGTACAAGTAAACGC
AGATTGCCACAGCCCA-1	ATCACCTTCC	------------------------------
CATCCACCAGTAACGG-1	ATCAGGCCCT	------------------------------
GCGCAACTCACTTATC-1	ATCATACTAA	TCGGCATGGACGAGCTGTACAAGTAAACGC
GTACTCCCAGTTTACG-1	ATCATTATCA	TCGGCATGGACGAGCTGTACAAGTAAACGC
AACACGTAGACTCGGA-1	ATCATTCGCA	TCGGCATGGACGAGC---------------
GTGCTTCAGTCTTGCA-1	ATCATTGTAA	----------------GTACAAGTAAACGC
GGCGTGTGTTGAGGTG-1	ATCATTTGTA	------------------------------
CTCTACGAGGGATGGG-1	ATCCAATATC	------------------------------
CGAGAAGAGGCATTGG-1	ATCCAATCTG	------------------------------
GCGCGATTCAACACCA-1	ATCCCAACTG	TCGGCATGGAC-------------------
GACGTTAAGCTGCGAA-1	ATCCCGTTAC	TCGGCATGGACGAGCTGTACAAGTAAACGC
ATTATCCCACACGCTG-1	ATCCCTAGAT	TCGGCATGGACGAGCTGTACAAGTAAACGC
CCGTACTAGTCGATAA-1	ATCCGTGCCT	TCGGCATGGACGAGCTGTACAAGTAAACGC
GTCACAACACACCGAC-1	ATCCGTGTCC	TCGGCATGGACGAGCTGTACAAGTAAACGC
ACGCAGCGTCAATACC-1	ATCCGTTGCT	-------------------------AACGC
TTTGCGCTCGGCCGAT-1	ATCCTAAACG	TCGGCATGGACGAGCTGTACAAGTAAACGC
CTGCCTAAGATCGGGT-1	ATCCTACTTT	------------------------------
TGGGAAGTCCCACTTG-1	ATCCTCGCAA	TCGGCATGGACGAGCTGTA-----------
CTACATTTCACATAGC-1	ATCCTGACCT	TCGGCATGGACGAGCTGTACAAGTAAACGC
AACCATGGTACAAGTA-1	ATCCTTCCCA	AAGGCATGAACGAGCTGTACAAGTAAACGC
ACGGAGATCAACCAAC-1	ATCGAAAACG	TCGGCATGGACGAGCTGTACAAGTAAACGC
AAGACCTCATTAACCG-1	ATCGATGTCC	------------------------------
CCATGTCTCAACGGGA-1	ATCGCTAGTT	TCGGCATGGACGAGCTGTACAAGTAAACGC
CTACCCATCGAGCCCA-1	ATCGGAGATC	------------------------------
TATCAGGTCAGCGATT-1	ATCGGCAGTG	TCGGCATGGACGAGCTGTACAAGTAAACGC
TGTTCCGAGTATGACA-1	ATCGGGATAT	TCGGCATGGACGAGCTGTACAAGTAAACGC
ACACCAAGTGTCGCTG-1	ATCGGGTTAG	TCGGCATGGACGAGCTGTACAAGTAAACGC
GTAGTCAAGTGATCGG-1	ATCGGTTTTG	------------------------------
CCTCAGTCATTCACTT-1	ATCTAATACA	-----ATGGACGAGCTGTACAAGTAAACGC
AATCCAGCATGTCCTC-1	ATCTACGATT	TCGGCATGGACGAGCTGTACAAGTAAACGC
TGTGGTAAGTGAACAT-1	ATCTAGGCTT	--------GACGAGCTGTACAAGTAAACGC
CAGAATCGTATGGTTC-1	ATCTATAAAG	TCGGCATGGACGAGCTGTACAAGTAAACGC
ATAAGAGCAGCTATTG-1	ATCTATAGAT	TCGGCATGGACGAGCTGTACAAGTAAACGC
TGGCCAGAGTGGAGTC-1	ATCTCACAAA	TCGGCATGGACGAGCTGTACAAGTAAACGC
AGAATAGGTGCCTGCA-1	ATCTCTTTTG	TCGGCATGGACGAGCTGTACAAGTAAACGC
GGTGAAGCATTCCTCG-1	ATCTGAAAAC	-----------GAGCTGTACAAGTAAACGC
TTCGGTCAGCTAACTC-1	ATCTGTGAGG	TCGGCATGGACGAGCTGTACAAGTAAACGC
TACACGACACAAGCCC-1	ATCTTACCGG	TCGGCATGGACGAGCTGTACAAGTAAACGC
CGAGCACTCGCTGATA-1	ATCTTCAACG	TCGGCATGGACGAGCTGTACAAGTAAACGC
TGCTGCTTCCGCAAGC-1	ATCTTGTAAG	TCGGCATGGACGAGCTGTACAAGTAAACGC
CTCATTAAGTGGACGT-1	ATCTTTCATT	TCGGCATGGACGAGCTGTACAAGTAAACGC
TGGCGCAGTTCAACCA-1	ATCTTTGGCC	TCGGCATGGACGAGCTGTACAAGTAAACGC
CTAGCCTCAAGCCGTC-1	ATCTTTGGTG	----------------GTACAAGTAAACGC
TCAGATGTCTATCCCG-1	ATGAACGTTT	TCGGCATGGACGAGCTGTACAAGTAAACGC
GATGAGGGTTGATTGC-1	ATGAAGTACG	------------------------------
CGAATGTTCGTTTATC-1	ATGACCCTAG	ACGGCATGGACGAGCTGTACAAGT------
CACATTTTCTTGTACT-1	ATGAGTCGCG	------------------------------
CTGTTTAGTCCTCTTG-1	ATGAGTTCTG	TCGGCATGGACGAGCTGTACAAGTAAACGC
GTGTTAGTCACCGTAA-1	ATGATCCACG	------------------------------
TAGTTGGAGAAGGTGA-1	ATGATGATTT	TCGGCATGGACGAGCTGTACAAGTAAACGC
AACTTTCGTACCATCA-1	ATGATGCGCA	TCGGCATGGACGAGCTGTACAAGTAAACGC
AACTCCCCACGAAACG-1	ATGATTAACA	TCGGCATGGACGAGCTGTACAAGTAAACGC
TTCTACATCATCTGTT-1	ATGATTCATC	TCGGCATGGACGAGCTGTACAAGTAAACGC
TATGCCCAGGGTATCG-1	ATGATTGAAT	TCGGCATGGACGAGCTGTACAAGTAAACGC
CTACCCATCCACGCAG-1	ATGCAACGGG	TCGGCATGGACGAGCTGTACAAGTAAACGC
CATCGGGCAGGGTACA-1	ATGCAGATTC	TCGACATGGACGAGCTGTACAAGTAAACGC
CGGAGCTAGGAATGGA-1	ATGCATCTTA	TCGGCATGGACGAGCTGTACAAGTAAACGC
ATAGACCCACACATGT-1	ATGCGAATGC	-------------------------TCGGC
CTCGAGGAGCTAACTC-1	ATGCGTCGCC	-------------GCTGTACAAGTAAACGC
CAGCATATCGCAAACT-1	ATGCGTGCTT	TCGGCATGGACGAGCTGTACAAGTAAACGC
GGCGTGTCATGCGCAC-1	ATGCTCTTCG	TCGGCATGGACGAGCTGTACAAGCAAACGC
CATCAGAAGGGTATCG-1	ATGCTGGCGG	TCGGCATGGACGAGCTGTACAAGTAAACGC
CATTATCAGCCACCTG-1	ATGCTTGGCC	------------------------------
CCACCTAAGCACCGCT-1	ATGGCCATCG	------------------------------
GTCACGGCAATCCAAC-1	ATGGCGCCAC	TCGGCATGGACGAGCTGTACAAGTAAACGC
GACACGCGTAGCGTCC-1	ATGGCGTCCG	TCGGCATGGACGAGCTGTACAAGTAAACGC
TAGGCATCACGTCTCT-1	ATGGGGCAGC	TCGGCATGGACGAGCTGTACAAGTAAACGC
GGGTTGCCAGCTGTTA-1	ATGGGTTTGC	TCGGCATGGACGAGCTGTACAAGTAAACGC
ATAAGAGAGCAGCCTC-1	ATGGTACCGG	TCGGCATGGACGAGCTGTACAAGTAAACGC
CGGACTGCACTGTGTA-1	ATGGTATGTT	------------------------------
GCATACATCGTGGTCG-1	ATGGTTCTGC	TCGGCATGGACGAGCTGTACAAGTAAACGC
CAGCTGGAGACTCGGA-1	ATGGTTTTTG	TCGGCATGGACGAGCTGTACAAGTAAACGC
CGCTTCACATATACCG-1	ATGTAATGCT	TCGGCATGGACGAGCTGTACAAGTAAACGC
CTCGTCATCCCGACTT-1	ATGTACCCCG	TCGGCATGGACGAGCTGTACAAGTAAACGC
GGTGTTAGTCAGAGGT-1	ATGTCAAGTG	------------------------------
AGGCCACTCTAACCGA-1	ATGTCACGTG	TCGGCATGGACGAGCTGTACAAGTAAACGC
GGGTTGCAGGCTAGAC-1	ATGTCTTCTG	TCGGCATGGACGAGCTGTACAAGTAAACGC
CTCATTAAGTGGACGT-1	ATGTGAATCG	----------------GTACAAGTAAACGC
ACATCAGAGACACGAC-1	ATGTGAATTG	TCGGCATGGACGAGCTGTACAAGTAAACGC
AGCTCCTGTGACAAAT-1	ATGTGGCGAC	------------------------------
GTGCAGCCATGAAGTA-1	ATGTGTAACT	-------GGACGAGCTGTACAAGTAAACGC
GTAGTCACAGCGTCCA-1	ATGTGTCACC	TCGGCATGGACGAG----------------
GAAACTCCACACTGCG-1	ATGTGTCTCG	--------GACGAGCTGTACAAGTAAACGC
GTCACAAAGCCAGAAC-1	ATGTTAAGAC	TCGGCATGGACGAGCTGTACAAGTAAACGC
CTTACCGCAATAAGCA-1	ATGTTCAGAA	TCGGCATGGACGAGCTGTACAAGTAAACGC
CGTCACTAGCAGACTG-1	ATGTTCGTCT	TCGGCATGGACGAGCTGTACAAGTAAACGC
CACCTTGGTTAGATGA-1	ATGTTGTACG	----CATGGACGAGCTGTACAAGTAAACGC
CGTTCTGTCAGGTAAA-1	ATGTTTTTTT	------------------------------
AACACGTAGGTGATAT-1	ATTAAAAAGG	TCGGCATGGACGAGCTGTACAAGTAAACGC
TGATTTCTCGCAAACT-1	ATTAAACTGC	TCGGCATGGACGAGCTGTACAAGTAAACGC
ATGTGTGAGTACGCCC-1	ATTAACAGCC	TCGGCATGGACGAGCTGTACAAGTAAACGC
TGAGAGGAGGTGACCA-1	ATTAACGATT	----------------------GTAAACGC
CTAATGGCAGCGAACA-1	ATTAATACTC	TCGGCATGGACGAGCTGTACAAGTAAACGC
AGAATAGGTCTGATTG-1	ATTAATTTTT	------------------------------
GTGCATAGTGAGGCTA-1	ATTACACTTT	TCGGCATGGACGAGCTGTACAAGTAAACGC
TCGGGACCATGCTGGC-1	ATTACATATA	------------------------------
GCCAAATAGCCGGTAA-1	ATTACATTAG	------------------------------
GTTCGGGAGACTTTCG-1	ATTACCGCAA	--------GACGAGCTGTACAAGTAAACGC
AAGGTTCCACAGACTT-1	ATTACTGTAA	---GCATGGACGAGCTGTACAAGTAAACGC
GACCTGGAGCGTGTCC-1	ATTAGCCTCT	TCGGCATGGACGAGCTGTACAAGTAAACGC
TACCTTAAGTACGCGA-1	ATTAGTAGAC	TCGGCATGGACGAGCTGTACAAGTAAACGC
GCTGCTTAGACTTTCG-1	ATTAGTATTT	TCGGCATGGA--------------------
TATGCCCGTTAGAACA-1	ATTATAGCGA	TCGGCATGGACGAGCTGTACAAGTAAACGC
AAGCCGCCATAGACTC-1	ATTATCAACC	--------------------AAGTAAACGC
CCGGTAGAGAGCCCAA-1	ATTATCCCGG	TCGGCATGGACGAGCTGTACAAGTAAACGC
CACACAATCGTCTGCT-1	ATTATTGCGA	TCGGCATGGACGAGCTGTACAAGTAAACGC
CTACCCATCGAGCCCA-1	ATTCACCTCT	--GGCATGGACGAGCTGTACAAGTAAACGC
CATCGGGCAGTCGTGC-1	ATTCAGCCAT	-------GGACGAGCTGTACAAGTAAACGC
GCGCCAACAACAACCT-1	ATTCATCAAA	------------------------------
GTCACAACAAGGGTCA-1	ATTCATGCGT	TCGGCATGGACGAGCTGTACAAGTAAACGC
ATTCTACCAGCCTATA-1	ATTCCGCGTA	----------------------GTAAACGC
CTCGAGGTCCATGAAC-1	ATTCCGCTCT	---------------------------CGC
GACTAACGTTAAGACA-1	ATTCCTGGCT	TCGGCATGGACGAGCTGTACAAGTAAACGC
ACGATACGTGTGCCTG-1	ATTCCTTCTT	TCGGCATGGACGAGCTGTACAAGTAAACGC
CCCAATCAGCTGCCCA-1	ATTCGAATAG	------------------------------
TACTCATAGCCACGCT-1	ATTCGACTTT	------------------------------
CCGTTCAGTCCCGACA-1	ATTCGAGTGT	TCGGCATGGACGAGCTGTACAAGTAAACGC
CCTAAAGGTTGATTCG-1	ATTCGTCAGG	TCGGCATGGACGAGCTGTTCAAGTAAACGC
TGCACCTCATGGTCTA-1	ATTCGTCGAC	TCGGCATGGACGAGCTGTACAAGTAAACGC
TGACTAGGTTAGGGTG-1	ATTCTAAACG	------------------------------
CCCATACCACCAGGCT-1	ATTCTACAAT	------------------------------
CTCACACAGTGTTGAA-1	ATTCTTCAGG	TCGGCATGGACGAGCTGTACAAGTAAACGC
ACGATGTCAGCCAATT-1	ATTGAACCCC	-----------GAGCTGTACAAGTAAACGC
AGTTGGTGTGAACCTT-1	ATTGATTTCC	TCGGCATGGACGAGCTGTACAAGTAAACGC
ACACCGGAGACAGACC-1	ATTGCATCTG	------------------------------
ACTGTCCCAGTAGAGC-1	ATTGCCTCCT	TCGGCATGGACGAGCTGTACAAGTAAACGC
CCGTGGACATATGAGA-1	ATTGCTTTGC	------------------------------
TTAACTCCATTGCGGC-1	ATTGGATTTA	------------------------------
CATCAAGAGTCAAGGC-1	ATTGGGGTCT	------------------------------
CTAGCCTTCCAAACTG-1	ATTGGTGCTG	------------------------------
CTCATTAAGCTAACTC-1	ATTGGTTATA	TCGGCATGGACGAGCTGTACAAGTAAACGC
GTCATTTGTTATCACG-1	ATTGTCAAAT	TCGGCATGGACGAGCTGTACAAGTAAACGC
AGCGTATAGCAGGTCA-1	ATTGTGATTT	------------------------------
ACACTGATCTCGTTTA-1	ATTTAAATCA	TCGGCATGGACGAGCTGTACAAGTAAACGC
CACCAGGTCGAATCCA-1	ATTTAACGGT	TCGGCATGGACGAGCTGTACAAGTAAACGC
TTCTACATCGTCTGCT-1	ATTTACAACT	TCGGCATGGACGAGCTGTACAAGTAAACGC
AACTCAGAGTTTGCGT-1	ATTTACACCC	TCGGCATGGACGAGCTGTACAAGTAAACGC
AAGACCTCACAACGTT-1	ATTTACCGTT	TCGGCATGGACGAGCTGTACAAGTAAACGC
TAAGCGTCAGACGCTC-1	ATTTACTGCT	TCGGCATGGACGAGCTGTACAAGTAAACGC
CAACTAGAGTCCAGGA-1	ATTTAGGATT	TCGGCATGGACGAGCTGTACAAGTAAACGC
CATGCCTAGGAGCGAG-1	ATTTATTAGT	------------------------AAACGC
TGCGCAGTCTTGAGGT-1	ATTTCAATGG	------------------------------
CCCATACTCAGCCTAA-1	ATTTCAGCTT	TCGGCATGGACGAGCTGTACAAGTAAACGC
TTAGGACCAAGTACCT-1	ATTTCGCGTC	TCGGCATGGACGAGCTGTACAAGTAAACGC
TCAACGAAGTGGACGT-1	ATTTCGGTGA	TCGGCATGGACGAGCTGTACAAGTAAACGC
CTTTGCGCAAGTCTAC-1	ATTTCTCCGT	TCGGCATGGACGAGCTGTACAAGTAAACGC
TAAGCGTCAGACGCTC-1	ATTTCTTCTG	TCGGCATGGACGAGCTGTACAAGTAAACGC
AGGTCCGCATCGGAAG-1	ATTTCTTTTG	TCGGCATGGACGAGCTGTACAAGTAAACGC
ATCCGAAGTCGCCATG-1	ATTTGCAATT	------------------------------
TAGCCGGCAAGGGTCA-1	ATTTGGCGAT	TCGGCATGGACGAGCTGTACAAGTAAACGC
CCAGCGACAAAGAATC-1	ATTTGGTCCT	TCGGCATGGACGAGCTGTACAAGTAAACGC
ACGTCAACAGACGCTC-1	ATTTGTTCCC	TCGGCATGGACGAGCTGTACAAGTAAACGC
GCGACCATCTCTAGGA-1	ATTTGTTGAT	TCGGCATGGACGAGCTGTACAAGTAAACGC
CTCGAAAAGAGTACCG-1	ATTTTAAACC	------------------------------
GAAGCAGCATCAGTAC-1	ATTTTAGCCC	TCGGCATGGACGAGCTGTACAAGTAAACGC
GTCAAGTGTATATGGA-1	ATTTTATATG	TCGGCATGGACGAGCTGTACAAGTAAACGC
CAGCTAACAGGAATCG-1	ATTTTCTGGG	------------------ACAAGTAAACGC
CTCGAAACACCAGTTA-1	ATTTTGGCAT	TCGGCATGGACGAGCTGTACAAGTAAACGC
CGATGGCGTAAACACA-1	ATTTTGTGTG	TCGGCATGGACGAGCTGTACAAGTAAACGC
CATATTCCAAGCGCTC-1	ATTTTGTTCC	TCGGCATGGACGAGCTGTACAAGTAAACGC
AACGTTGAGACAATAC-1	ATTTTTACGA	------------------------------
CAGCCGAGTGAAATCA-1	ATTTTTCGGA	TCGGCATGGACGAGCTGTACAAGTAAACGC
TCACGAACAGTTAACC-1	ATTTTTTAAG	TCGGCATGGACGAGCTGTACAAGTAAACG-
CGTTAGATCTGCAAGT-1	ATTTTTTGGG	TCGGC-------------------------
CCCAATCAGTTATCGC-1	ATTTTTTGTC	TCGGCATGGACGAGCTGTACAAGTAAACGC
TGCGTGGAGATGGCGT-1	CAAAAACCAG	TCGGCATAGACGAGCTGTACAAGTAAACGC
TCAGATGAGCTGATAA-1	CAAAACATAT	TCGGCATGGACGAGCTGTACAAGTAAACGC
CGATGGCGTGACGGTA-1	CAAACACAGG	TCGGCATGGACGAGCTGTACAAGTAAACGC
CTCCTAGGTTGTGGAG-1	CAAACCTCTC	TCGGCATGGACGAGCTGTACAAGTAAACGC
GCGCGATCACCTGGTG-1	CAAACCTTTG	TCGGCATGGACGAGCTGTACAAG-------
ATTCTACCAGCCTATA-1	CAAACTTAGG	TCGGCATGGACGAGCTGTACAAGTAAACGC
AACTTTCGTAGAAAGG-1	CAAATCTAAT	TCGGCATGGACGAGCTGTACAAGTAAACGC
CCACCTAAGCACCGCT-1	CAAATCTTCG	TCGGCATCGACGAGCTGTAAAAGTAAACGA
CGGACTGCACTGTGTA-1	CAAATGATCA	TCGGCATGGACGAGCTGTACAAGTAAACGC
CCTAAAGTCATAAAGG-1	CAAATTCAGT	TCGGCA------------------------
GACGCGTAGATACACA-1	CAACAAGCAT	TCGGCATGGACGAGCTGTACAAGTAAACGC
GGTATTGGTAAGTAGT-1	CAACCGCCGT	------------------------AAACGC
GAAACTCAGGTGCAAC-1	CAACGTAATA	TCGGCATGGACGAGCTGTACAAGTAAACGC
CTGAAGTAGCGAGAAA-1	CAACTCTTAT	TCGGCATGGACGAGCTGTACAAGTAAACGC
ACAGCCGGTTCGCGAC-1	CAACTGGTTG	------------------------------
CGTTCTGAGAGCTATA-1	CAACTTTTGG	TCGGCATGGACGAGCTGTACAAGTAAACGC
TTGCGTCAGTCGTTTG-1	CAAGAGGTTT	TCGGCATGGACGAGCTGTACAAGTAAACGC
GGATTACCACTCGACG-1	CAAGATTCGG	------------------------------
GGGATGACAACGATGG-1	CAAGCAATGG	TCGGCATGGACGAGCTGTACAAGTAAACGC
AACGTTGCAGATGGCA-1	CAAGCAGTGG	TCGGCATGGACGAGCTGTACAAGTAAACGC
GCGAGAAGTACTCTCC-1	CAAGCCGTCA	------------------------------
GCGAGAAGTACTCTCC-1	CAAGCCGTCA	------------------------------
TCTGAGATCATGTCCC-1	CAAGGAATCA	TCGGCATGGACGAGCTGTACAAGTAAACGC
GACTGCGAGGATGCGT-1	CAAGGCCCTG	TCGGCATGGACGAGCTGTACAAGTAAACGC
GCGCAGTCATCCCACT-1	CAAGGCTATT	TCGGCATGGACGAGCTGTACAAGTAAACGC
CGGAGTCGTTACGACT-1	CAAGGCTTGG	---GCATGGACGAGCTGTACAAGTAAACGC
TCAGCAATCACAGTAC-1	CAAGGTAGCA	TCGGCATGGACGAGCTGTACAAGTAAATGC
GCACATAAGCGTAGTG-1	CAAGTCCGAT	TCGGCATGGACGAGCTGTACAAGTAAACGC
TAGTTGGCAAGGACTG-1	CAAGTCGCGG	TCGGCATGGACGAGCTGTACAAG-------
AGGGTGACAGATGGGT-1	CAAGTGCTTG	TCGGCATGGACGAGCTGTACAAGTAAACGC
ATGAGGGTCCAACCAA-1	CAAGTTTTAG	TCGGCATGGACGAGCTGTACAAGTAAACGC
TACGGTAAGGTGATAT-1	CAATAACATA	TCGGCATGGACGAGCTGTACAAGTAAACGC
GGGAATGTCACGCATA-1	CAATACTTTG	------------------------------
CGCTATCGTTACGGAG-1	CAATATATTT	TCGGCATGGACGAGCTGTACAAGTAAACGC
ACCCACTAGAGAGCTC-1	CAATCACAAG	------------------------------
ACAGCCGGTACGACCC-1	CAATCACCTG	TCGGCATGGACGAGCTGTACAAGTAAACGC
GCTTGAACAGGAACGT-1	CAATCATAAA	------------------------------
AGCGTATAGGCATGTG-1	CAATCCCAAA	TCGGCATGGACGAGCTGTACAAGTAAACGC
CTAATGGGTTTGACTG-1	CAATCCTATG	TCGGCATGGACGAGCTGTACAAGTAAACGC
CAGTAACAGATACACA-1	CAATCGGCGT	TCGGCATGGACGAGCTGTACAAGTAAACGC
CCACGGACACACCGAC-1	CAATGGCTCA	TCGGCATGGACGAGCTGTACAAGTAAACGC
CGAGCCATCCTCAATT-1	CAATTAACGA	TCGGCATGGACGAGCTGTACAAGTAA----
GAATGAAAGCGAAGGG-1	CAATTGACTT	TCGGCATGGACGAGCTGTACAAGTAAACGC
TGAAAGAAGGAATTAC-1	CAATTGTTTG	TCGGCATGGACGAGCTGTACAAGTAAACGC
TATTACCGTCGGCATC-1	CAATTTCAAG	TCGGCATGAACGAGCTGTACAAGTAAACGC
TATGCCCAGGGTATCG-1	CAATTTCCAT	TCGGAATGGACGAGCTGTACAAGTAAACGC
GGGACCTCAATGACCT-1	CAATTTTCAA	TCGGCATGGACGAGCTGTACAAGTAAACGC
CTGTGCTTCTGGTATG-1	CACAAATAAG	TCGGCATGGACGAGCTGTACAAGTAAACGC
CTCGAGGTCCATGAAC-1	CACAACTCAT	TCGGCATGGACGAGCTGTACAAGTAAACGC
TCAGATGGTATAGGTA-1	CACAATGGCA	------------------------------
ATCACGATCAGTCAGT-1	CACACAATTG	-----------------------TAAACGC
GTCACGGAGGAATGGA-1	CACACAATTT	-------GGACGAGCTGTACAAGTAAACGC
CACCTTGTCGCTTAGA-1	CACAGCCGTT	TCGGCATGGACGAGCTGTACAAGTAAACGC
CCGTGGAGTAGTACCT-1	CACAGCGACA	TCGGCATGGACGAGCTGTACAAGTAAACGC
ACAGCTAGTCACAAGG-1	CACAGTTTGG	------------------------------
ACTGAGTCAATAAGCA-1	CACATACCTG	TCGGCATGGACGATCTGTACAAGTAAACGC
ACAGCCGAGGACAGAA-1	CACATCACGC	TCGGCATGGACGAGCTGTACAAGTAAACGC
GCACATAAGTTCCACA-1	CACATGAAGA	TCGGCATGGACGAGCTGTACAAGTAAACGC
GGCTGGTTCGTTTGCC-1	CACCAAAATA	TCGGCATGGACGAGCTGTACAAGTAAACGC
ATGTGTGGTCTCCCTA-1	CACCACCTAG	TCGGCATGGACGAGCTGTACAAGTAAACGC
CCACTACGTTTGCATG-1	CACCACGGGT	TCGGCATGGACGAGCTGTACAAGTAAACGC
CCTACCAGTGTGCGTC-1	CACCCAGGCT	------------------------------
ACTGAGTTCAAAGACA-1	CACCCCGTTT	TCGGCATGGACGAGCTGTACAAGTAAACGC
CATGCCTAGGAGCGAG-1	CACCGTAGTG	TCGGCATGGACGAGCTGTACAAGTAAACGC
TCCCGATCATCACGTA-1	CACCGTATCC	TCGGCATGGACGAGCTGTACAAGTAAACGC
ATTCTACGTACAGTTC-1	CACCGTCAGA	------------------------------
TCAATCTGTTACAGAA-1	CACCTGCTTT	TCGGCATGGACGAGCTGTACAAGTAAACGC
AGCGGTCGTCTCTCGT-1	CACCTGTTCG	TCGGCATGGACGAGCTGTACAAGTAAACGC
TGCTGCTTCTACTCAT-1	CACCTGTTCT	TCGGCATGGACGAGCTGTACAAGTAAACGC
TACGGATAGCTAAACA-1	CACGACCCTT	------------------------------
AGCCTAATCCTCCTAG-1	CACGCCTTGG	------------------------------
GCGACCATCTCTAGGA-1	CACGCTTTTG	------------------------------
AAACCTGAGCGACGTA-1	CACGGACTTG	TCGGCATGGACGAGCTGTACAAGTAAACGC
CGACCTTAGAGACTTA-1	CACGGTTGCA	----------------GTACAAGTAAACGC
TCTCATACATCATCCC-1	CACGTGCTTT	TCGGCATGGACGAGCTGTACAA--------
GGGCACTCACAGAGGT-1	CACTAAGGGT	TCGGCATGGACGAGCTGTACAAGTAAACGC
CTAGTGATCGCGATCG-1	CACTAGGTTT	------------------------------
TCGGTAATCAGGCGAA-1	CACTCACATG	------------------------------
TCGCGAGTCAGGCAAG-1	CACTCATCAA	TCGGCATGGACGAGCTGTACAAGTAAACGC
TACGGTAAGGGAGTAA-1	CACTCGTCTC	------------------------------
CATCAGAGTTACGACT-1	CACTCTGATT	------------------------------
CGAGCACGTCCGAGTC-1	CACTCTTGTT	TCGGCATGGACGAGCTGTACAAGTAAACGC
CAGCATATCGCAAACT-1	CACTGGAGCT	TCGGCATGGACGAGCTGTACAAGTAAACGC
GTCTCGTCAAGAGTCG-1	CACTTAAATA	TCGGCATGGACGAGCTGTACAAGTAAACGC
CACACAACACGTTGGC-1	CACTTAGCTT	TCGGCATGGACGAGCTGTACAAGTAAACGC
GCGCGATTCAACACCA-1	CACTTCTGAT	TCGGCATGGACGAGCTGTACAAGTAAACGC
ACATCAGCATGGTTGT-1	CACTTGAGGC	TCGGCATGGACGAGCTGTACAAGTAAACGC
GGCAATTCACACCGCA-1	CACTTTAATT	TCGGCATGGACGAGCTGTACAAGTAAACGC
AACTGGTAGACTTGAA-1	CACTTTTAAT	TCGGCATGGACGAGCTGTACAAGTAAACGC
GTAACGTCAATGGAGC-1	CAGAAAATGC	TCGGCATGGACGAGCTGTACAAGTAAACGC
CGACTTCGTTGGGACA-1	CAGAAATATC	TCGGCATGGACGAGCTGTACAAGTAAACGC
AATCCAGAGATGAGAG-1	CAGACATATT	------------------------------
GTGCAGCCATGAAGTA-1	CAGACGGAGT	TCGGCATGGACGAGCTGTACAAGTAAACGC
TGGCGCATCTGCGTAA-1	CAGACTGCTC	TCGGCATG----------------------
TTGCGTCGTGGAAAGA-1	CAGAGTTAAT	------------------------------
CCTTACGTCGGATGGA-1	CAGATATATT	TCGGCATGGACGAGCTGTACAAGTAAACGC
CCTAGCTCAGCGATCC-1	CAGATTGACT	TCGGCATGGACGAGCTGTACAAGTAAACGC
TGGGCGTAGGCGATAC-1	CAGCAGCTGG	TCGGCATGGACGAGCTGTACAAGTAAACGC
TGGCCAGTCTTGTTTG-1	CAGCCGCTAA	TCGGCATGGACGAGCTGTACAAGTAAACGC
CGTTGGGTCCGTCAAA-1	CAGCCTTTTC	TCGGCATGGACGAGCTGTACAAGTAAACGC
GAGGTGATCCTCTAGC-1	CAGCGTCAGC	TCGGCATGGACGAGCTGTACAAGTAAACGC
GCTCCTACACCATGTA-1	CAGCTATTCA	TCGGCATGGACGAGCTGTACAAGTAAACGC
GTCGTAATCCCATTTA-1	CAGCTCGTTG	--------GACGAGCTGTACAAGTAAACGC
CCGTGGAAGGCATGGT-1	CAGGGAGGAA	TCGGCATGGACGAGCTGTACAAGTAAACGC
TACTCGCAGTTCGCGC-1	CAGGGTCAAC	TCGGCATGGACGAGCTGTACAAGTAAACGC
CGCTTCATCCAGAGGA-1	CAGGTAGCAC	TCGGCATGGACGAGCTGTACAAGTAAACGC
CATATTCGTTCGTTGA-1	CAGTAGTGCG	----------------------GTAAACGC
GCGACCACAGACGCCT-1	CAGTATAAGG	TCGGCATGGACGAGCTGTACAAGTAAACGC
TGAAAGAAGCACGCCT-1	CAGTCCGATA	TCGGCATGGACGAGCTGTACAAGTAAACGC
ACGGGCTTCAAAGACA-1	CATAAATATT	------------------------------
ACTGTCCCAGTAGAGC-1	CATAAGCAGT	------------------------------
GACAGAGAGCTGGAAC-1	CATAAGCGGT	------------------------------
GACGGCTAGTGTTAGA-1	CATAATGTCC	TCGGCATGGACGAGCTGTACAAGTAAACGC
GGAACTTGTTCAGCGC-1	CATACCCATT	TCGGCATGGACGAGCTGTACAAGTAAACGC
CGACCTTGTGTTGAGG-1	CATACGGCTT	TCGGCATGGACGAGCTGTACAAGTAAACGC
CAGCATATCGCAAACT-1	CATACTCCTC	TCGGCATGGACGAGCTGTACAAGTAAACGC
CGGACGTGTGGAAAGA-1	CATAGCGACG	TCGGCATGGACGAGCTGTACAAGTAAACGC
GGACAGAAGAACTCGG-1	CATAGCTACG	ACGGCATGTACGACCTGTACAAGTAAACGC
TGGTTAGAGTACGCGA-1	CATATACGGG	TCGGCATGGACGAGCTGTACAAGTAAACGC
ACTATCTTCATTGCCC-1	CATATGTTTT	CCGGCATGGACGAGCTGTACAAGTAAACGC
CCACTACAGGGAAACA-1	CATATTCTTT	TCGGCATGGACGAGCTGTACAAGTAAACGC
TATCAGGAGCGTTGCC-1	CATCACGTTT	TCGGCATGGACGAGCTGTACAAGTAAACGC
CCGTGGACACTTCGAA-1	CATCCAATGG	TCGGCATGGACGAGCTGTACAAGTAAACGC
GCAGCCAGTTTGTGTG-1	CATCCGACAA	------------------------------
GATGAAAAGCGTGAAC-1	CATCCGGGGG	TCGGCATGGACGAGCTGTACAAGTAAACGC
CTGAAGTCACCGATAT-1	CATCCTCAGG	TAGAAAAGAACGAGCTGTACAAGTAAACGC
CTTGGCTTCTTTACGT-1	CATCGAATGC	TCGGCATGGACGAGCTGTACAAGTAAACGC
TACTCATGTAGCCTAT-1	CATCGCATTA	------------------------------
CAGCAGCGTAAAGGAG-1	CATCGCTGCT	--GGCATGGACGAGCTGTACAAGTAAACGC
CAGCGACAGCAGGCTA-1	CATCGGCATT	TCGGCATGGACGAGCTGTACAAGTAAACGC
CACATTTGTAAGGATT-1	CATCGGTGCT	------------------------AAACGC
TGGCCAGCACGAAGCA-1	CATCTACCCC	TCGGCATGAACGAGCCGTACAAGTAAACGC
TCGCGAGTCAGGCAAG-1	CATCTCTTTA	TCGGCATGGACGAGCTGTACAAGTAAACGC
TACTCATTCGGAAATA-1	CATGATATCC	------------------------------
ATAAGAGAGCAGCCTC-1	CATGATTACC	TCGGCATGGACGAGCTGTACAAGTAAACGC
ACAGCCGAGGACAGAA-1	CATGCATCAG	TCGGCATGGACGAGCTGTACAAGTAAACGC
CCTTACGTCGAGAACG-1	CATGCCTTAC	TCGGCATGGACGAGCTGTACAAGTAAACGC
TGTTCCGCAAATCCGT-1	CATGCTGTTC	TCGGCATGGACGAGCTGTACAAGTAAACGC
GATCGCGTCAGTTCGA-1	CATGGGCATC	-------TCGGCATGGACGAGCTGTACAAG
CGAGAAGCATCTGGTA-1	CATGTCACGG	TCGGCATGGACGAGCTGTACAAGTAAACGC
CACCTTGTCGCTTAGA-1	CATGTCTGAT	TCGGCATGGACGAGCTGTACAAGTAAACGC
ACGATACCACGAGAGT-1	CATGTGGGGT	TCGGCATGGACGAGCTGTACAAGTAAACGC
ATTACTCTCGAGCCCA-1	CATTAAGTTT	------------------------------
TGACTTTGTATAGGGC-1	CATTACGTGG	------------------------------
TGACTTTGTATAGGGC-1	CATTACGTGG	TCGGCATGGACGAGCTGTACAAGTAAACGC
CGTCACTGTTACTGAC-1	CATTACTGTA	TCGGCATGGACGAGCTGTACAAGTAAACGC
TGACTAGGTGGTAACG-1	CATTAGAATG	------------------------------
TCTATTGCAGGGTTAG-1	CATTCGAATT	TCGGCATGGACGAGCTGTACAAGTAAACGC
CTCGTACCAATCAGAA-1	CATTCGTTGC	TCGGCATGGACGAGCTGTACAAGTAAACGC
GCATGCGCAAGCTGGA-1	CATTCTCAAT	------------------------------
GTTCTCGAGAACTCGG-1	CATTCTTAGG	TCGGCATGGACGAGCTGTACAAGTAAACGC
AGCGTCGTCACCGTAA-1	CATTCTTTAC	TCGGCATGGACGAGCTGTACAAGTAAACGC
TCTTCGGGTAGTACCT-1	CATTGCATAC	TCGGCAGGGACGAGCTGTACCAGTAAAAGC
AGCAGCCTCTACGAGT-1	CATTGCTTCC	TCGGCATGGACGAGCTGTACAAGTAAACGC
TCAATCTAGACACTAA-1	CATTGGAATG	TCGGCATGGACGAGCTGTACAAGTAAACGC
CGAGAAGTCTTGCATT-1	CATTGGCCTC	TCGGCATGGACGAGCTGTACAAGTAAACGC
CGAGCACTCTGCGTAA-1	CATTGTTCGC	---GCATGGACGAGCTGTACAAGTAAACGC
TACTTGTCATCACAAC-1	CATTTATTCT	ACGGCATGGACGAGCTGTACAAGTAAACGC
CTCATTATCATTGCGA-1	CATTTATTTG	TCGGCATGGACGAGCTGTACAAGTAAACGC
CGATGGCCACAGACAG-1	CATTTTGTGT	TCGGCATGGACGAGCTGTACAAGTAAACGC
AACTCCCGTCTTCGTC-1	CCAAAACTTC	TCGGCATGGACGAGCTGTACAAGTAAACGC
TGTTCCGGTTGCGCAC-1	CCAAACGCCC	TCGG--------------------------
GCACATAAGTTCCACA-1	CCAAAGACTT	TCGGCATGGACGAGCTGTACAAGTAAACGC
CCTAGCTAGAGTACCG-1	CCAACAATAG	TCGGCATGGACGAGCTGTACAAGTAAACGC
TTAGTTCTCGAACTGT-1	CCAACAATAT	TCGGCATGGACGAGCTGTACAAGTAAACGC
TTTGCGCTCTAGAGTC-1	CCAACAGCAT	------------------------------
ACTATCTTCCGTTGTC-1	CCAAGGCGAG	-----------GAGCTGTACAAGTAAACGC
TGGCCAGTCTTGTTTG-1	CCAATGGGTG	TCGGCATGGACGAGCTGTACAAGTAAACGC
ACTGATGTCGCCAGCA-1	CCACCCTATG	TCGGCATGGACGAGCTGTACAAGTAAACGC
ACACTGAAGAGTACCG-1	CCACGCTGAG	TCGGCATGGACGAGCTGTACAAGTAAACGC
AACACGTAGGTGATAT-1	CCACGTCCGG	------------------------------
CAAGTTGGTTCACCTC-1	CCACGTTTAT	TCGGCATGGACGAGCTGTACAAGTAAACGC
CGCTGGAAGACAAAGG-1	CCACTACATG	TCGGCATGGACGAGCTGTACAAGTAAACGC
TTGAACGGTTGGGACA-1	CCACTGGTTA	TCGGCATGGACGAGCTGTACAAGTAAACGC
CTAGTGACATATACGC-1	CCACTTGGGT	TCGGCATGGACGAGCTGTACAAGTAAACGC
TAAGCGTTCGTTGACA-1	CCACTTTACG	TCGGCATGGACGAGCTGTACAAGTAAACGC
AAACGGGCATGTTCCC-1	CCACTTTTGT	TCGGCATGGACGAGCTGTACAAGTAAACGC
TCATTTGGTCAGCTAT-1	CCAGAATTGG	TCGGCATGGACGAGCTGTACAAGTAAACGC
CAAGATCCATTGGGCC-1	CCAGGCAAGT	TCGGCATGGACGAGCTGTACAAGTAAACGC
AGGTCATCACTCAGGC-1	CCAGGCTTGC	TCGGCATGGACGAGCTGTACAAGTAAACGC
CAGCTGGGTTAAAGAC-1	CCAGGGCCAT	TCGGCATGGAC-------------------
CTCACACGTACTTAGC-1	CCAGTAGACC	TCGGCATGGACGAGCTGTACAAGTAAACGC
CTCGGGACAGTTTACG-1	CCAGTAGATT	----CATGGACGAGCTGTACAAGTAAACGC
CCAATCCTCTTGAGAC-1	CCAGTTCTGG	TCGGCATGGACGAGCTGTACAA--------
CAAGAAATCGCAAACT-1	CCATAATTTG	TCGGCATGGACGAGCTGAACAAGTAAACGC
TTCGAAGTCGTTTATC-1	CCATACCCAA	TCGGCATGGACGAGCTGTACAAGTAAACGC
CGAGCACTCGCTGATA-1	CCATAGTATT	TCGGCATGGACGAGCTGTACAAGTAAACGC
CCTAAAGGTACAGCAG-1	CCATATAGAC	------------------------------
GGCGTGTGTCATGCAT-1	CCATCTCGGA	TCGGCATGGACGAGCTGTACAAGTAAACGC
TACTCATAGCCACGCT-1	CCATGTCGGT	------------------------------
GGAAAGCGTAGGCTGA-1	CCATTCTCTA	TCGGCATGGACGAGCTGTACAAGTAAACGC
TTGGCAAAGGAGTCTG-1	CCATTTCTGT	TCGGCATGGACGAGCTGTA-----------
CGCGGTACATGAAGTA-1	CCCAAAATCA	TCGGCATGGACGAGCTGTACAAGTAAACGC
CTCATTATCCTATTCA-1	CCCAACGTTC	TCGGCATGGACGAGCTGTACAAGTAAACGC
AGGCCACGTAGCCTAT-1	CCCACACATG	TCGGCATGGACGAGCTGTACAAGTAAACGC
CAGATCAGTTAAAGTG-1	CCCACGTTGG	TCGGCATGGACGAGCTGTACAAGTAAACGC
TCTGAGATCATGTCCC-1	CCCAGGAGTT	TCGGCATGGACGAGCTGTACAAGTAAACGC
AACTCTTGTCAGTGGA-1	CCCAGGGGCA	TCGGCATGGACGAGCTGTACAAGTAAACGC
TTTACTGCATCCCATC-1	CCCAGTAACG	TCGGCATGGACGAGCT--------------
GGTATTGCAAAGTCAA-1	CCCATAAGTC	TCGGCATGGACGAGCTGTACAAGTAAACGC
GCTGGGTTCGCCAGCA-1	CCCATGAGTG	TCGGCATGGACGAGCTGTACAAGTAAACGC
AGAGCTTCATCACAAC-1	CCCATTTTGA	TCGGCATGGA--------------------
GCTTCCAGTCAGGACA-1	CCCCACGGAG	TCGGCATGGACGAGCTGTACAAGTAAACGC
ACTATCTTCCCTAACC-1	CCCCCGCAAA	----------------GTACAAGTAAACGC
CGAGCCACACATTAGC-1	CCCCCTAGGT	------------------------------
ATAACGCCACAAGCCC-1	CCCCGGACAA	TCGGCATGGACGAGCTGTACAAGTAAACG-
TAAACCGGTTCAACCA-1	CCCCGGCTCA	TCGGCATGGACGAGCTGTACAAGTAAACGC
TACGGTAAGGTGATAT-1	CCCCGGGTCT	TCGGCATGGACGAGCTGTACAAGTAAACGC
CGTTGGGAGCATGGCA-1	CCCCTACTCC	TCGGCATGGACGAGCTGTACAAGTAAACGC
CACCAGGCATAAAGGT-1	CCCCTCGGCT	TCGGCATGGACGAGCTGTACAAGTAAACGC
TTTATGCCACTTACGA-1	CCCCTCTAGT	-----------------------------C
CATTCGCAGCTCCCAG-1	CCCCTGCTGA	TCGGCATGGACGAGCTGTACAAGTAAACGC
TGGGAAGTCTACGAGT-1	CCCCTGTACC	TCGGCATGGACGAGCTGTACAAGTAAACGC
ACGATACTCTCGCTTG-1	CCCCTGTCAT	-------------GCTGTACAAGTAAACGC
ATAACGCCACTTAACG-1	CCCGAAGCCG	------------------------------
ACTTTCACATGACGGA-1	CCCGAAGGCT	-----------GAGCTGTACAAGTAAACGC
CACCAGGCATAAAGGT-1	CCCGAGCCCG	TCGGCATGGACGAGCTGTACAAGTAAACGC
CCTACCAAGACAATAC-1	CCCGATCGAG	------------------------------
CTTAACTCAAACCCAT-1	CCCGGACTCT	-----------------------------C
GATCGCGAGCTAGTGG-1	CCCGGATGGT	TCGGCATGGACGAGCTGT------------
TAAGCGTCACACATGT-1	CCCGGATTTA	TCGGCATGGACGAGCTGTACAAGTAAACGC
CACATTTAGTACGCGA-1	CCCGGGACTC	CCGGCATGGACGAGCTGTACAAGTAAACGC
AATCCAGCATGACATC-1	CCCGGGCGTA	------------------------------
CTGAAGTGTCAAACTC-1	CCCGGGCTAC	------------------------------
TCTCATAGTGGTGTAG-1	CCCGGGGTGA	TCGGCATGGACGAGCTGTACAAGTAAACGC
GACTACAAGTCTCCTC-1	CCCGTATCGA	TCGGCATGGACG------------------
GGAACTTGTCAACATC-1	CCCGTGTCCG	TCGGCATGGACGAGCTGTACAAGTAAACGC
CGCCAAGGTGGCTCCA-1	CCCGTGTCGA	TCGGCATGGACGAGCTGTACAAGTAAACGC
CACACAAGTGTTAAGA-1	CCCGTTTTAT	TCGGCATGAACGAACTGTACAAGTAAACGC
TGCGCAGTCTAACTGG-1	CCCTACTGGT	TCGGCATGGACGAGCTGTACAAGTAAACGC
CAAGAAAGTTGAGTTC-1	CCCTACTTTG	TCGGCATGGACGAGCTGTACAAGTAAACGC
CGTCACTAGCTAGTTC-1	CCCTAGGCCG	----------------------------GC
ACGCCGATCAACGAAA-1	CCCTAGTAAC	TCGGCATGGACGAGCTGTACAAGTAAACGC
TACTCGCGTTATCACG-1	CCCTATCCTT	TCGGCATGGACGAGCTGTACAAGTAAACGC
AGCAGCCTCTACGAGT-1	CCCTATTTTA	TCGGCATGGACGAGCTGTACA---------
CGCTTCAGTCCCTACT-1	CCCTCGCATT	TCGGCATGGACGAGCTGTACAAGTAAACGC
AGGCCACAGATCGATA-1	CCCTCGTTCT	TCGGCATGGACGAGCTGTACAAGTAAACGC
TGTGGTATCAGTCAGT-1	CCCTCTTGTC	TCGGCATGGACGAGCTGTACAAGTAAACGC
TGTGGTAGTAATAGCA-1	CCCTGTAATA	------------------------------
CCGTGGAAGATAGCAT-1	CCCTGTCTGT	TCGGCATGGACGAGCTGTACAAG-------
GTCCTCAGTCACCCAG-1	CCCTGTTTCG	TCGGCATGGACGAGCTGTACAAGTAAACGC
AAACCTGGTCGCATAT-1	CCCTTAGTAG	------------------------------
AGGGAGTAGTGGTAGC-1	CCCTTGAGTG	TCGGCATGGACGAGCTGTACAAGTAAACGC
GGACAGAAGAGGTTAT-1	CCCTTGTGTT	TCGGCATGGACGAGCTGTACAAGTAAACGC
CGATGTAAGATCCTGT-1	CCCTTGTTTC	------------------------------
TAGTTGGTCCAACCAA-1	CCGAAAAACT	TCGGC-------------------------
ACCCACTAGAGAGCTC-1	CCGAAGTGTA	TCGGCATGGACGAGCTGTACAAGTAAACGC
CAGCTAAGTAGGACAC-1	CCGACGAATT	---------------------AGTAAACGC
CTCGGGAAGCACGCCT-1	CCGAGAACTG	----------------GTACAAGTAAACGC
CTACCCATCAGCAACT-1	CCGATCATGG	TCGGCATGGACGAGCTGTACAAGTAAACGC
CGAATGTCACTGTCGG-1	CCGATCGCCT	TCGGCATGGACGAGCTGTACAAG-------
GTCATTTCATCCTAGA-1	CCGATTACAT	------------------------------
AACACGTGTACAGACG-1	CCGCACAGGA	TCGGCATGGACGAGCTGTACAAGTAAACGC
TGGCTGGGTAGGACAC-1	CCGCACCAAG	TCGGTATGGACGAGCTGTACAAGTAAACGC
GCTCTGTTCAGTTAGC-1	CCGCAGACGA	TCGGCATGGACGAGCTGTACAAGTAAACGC
CACATAGAGTGGCACA-1	CCGCATCCTG	TCGGCATGGACGAGCTGTACAAGTAAACGC
CCTAGCTCAGCCTGTG-1	CCGCCACGGG	TCGGTATGGACGAGCTGTACAAGTAAACGC
TGAGGGAGTCTTCTCG-1	CCGCCATCCT	TCGGCATGGACGAGCTGTACAAGTAAACGC
CACATTTCATGCAATC-1	CCGCGCCCTT	------------------------------
GTTACAGCAAAGGAAG-1	CCGCGTCAGC	TCGGCATGGACGAGCTGTACAAGTAAACGC
GTTCATTGTACTTCTT-1	CCGCTACAAA	TCGGCATGGACGAGCTGTACAAGTAAACGC
CCCAATCAGCTGCCCA-1	CCGCTATTTT	TCGGCATGGACGAGCTGTACAAGTAAACGC
CTCGAGGGTCGCTTCT-1	CCGGAGGTCG	TC----------------------------
CCTCAGTAGCTACCTA-1	CCGGATTTCT	TCGGCATGGACGAGCTGTACAAGTAAACGC
GTCTTCGAGCGAGAAA-1	CCGGCAGCTT	TCGGCATGGACGAGCTGTACAAGTAAACGC
GTCTTCGCACGTCTCT-1	CCGGGTGATT	TCGGCATGGACGAGCTGTACAAGTAAACGC
AGCTCCTAGATCACGG-1	CCGGTGGTCC	TCGGCATGGACGAGCTGTACAAGTAAACGC
CTAGAGTCATGCGCAC-1	CCGGTGTTGT	TCGGCATGGACGAGCTGTACAAGTAAACGC
CGATGGCAGAGGACGG-1	CCGTAAGATT	TCGGCATGGACGAGCTGTACAAGTAAACGC
CAACCAAGTCGAACAG-1	CCGTAAGCGT	TCTGCATGGACGAGCTGTACAAGTAAACGC
CTAAGACCATGGATGG-1	CCGTACAAGC	TCGGCGTGGACGAGCTGTACAAGTAAACGC
GCTTCCACAGTCGATT-1	CCGTACCCGG	TCGGCATGGACGAGCTGTACAAGTAAACGC
CATCAAGTCCTAAGTG-1	CCGTACTCTT	------------------------------
TGGGAAGGTGGCTCCA-1	CCGTATGTCT	------------------------------
ATCCGAATCCGCATAA-1	CCGTCATAGG	------------------------------
GGACAGAAGAACTCGG-1	CCGTCCGGAT	---------------TGTACAAGTAAACGC
AAATGCCCATCCAACA-1	CCGTCGGGGT	------------------------------
CCTTCGATCGTGGACC-1	CCGTGCGGTG	TCGGCATGGACGAGCTGTACAAGTAAACGC
CCCATACTCAGTCAGT-1	CCGTGTTTCA	------------------------------
TTGTAGGTCTTGTCAT-1	CCGTTCCATT	TCGGCATGGACGAGCTGTACAAGTAAACGC
TTAGGACTCTTTACAC-1	CCGTTCGGTC	------------------------------
TTGAACGAGCCACGCT-1	CCGTTGCAGT	TCGGCATGGACGAGCTGTACAAGTAAACGC
GTCACGGCAATCCAAC-1	CCGTTTCCCT	----------------------GTAAACGC
GCGCCAAGTTCCTCCA-1	CCTAAATTAT	TCGGCATGGACGAGCTGTACAAGTAAACGC
CTAGCCTGTGCCTGTG-1	CCTAACGCTC	TCGGCATGGACGAGCTGTACAAGTAAACGC
CAAGGCCGTATAGGGC-1	CCTAAGCGGT	TCGGCATGGACGAGCTGTACAAGTAAACGC
CAGAGAGCAAGCGAGT-1	CCTACAACCG	TCGGCATGG---------------------
TTCTCAAAGGGCACTA-1	CCTACAAGGT	TCGGCATGGACGAGCTGTACAAGTAAACGC
TAGACCATCCGAATGT-1	CCTACAGCTC	TCGGCATGGACGAGCTGTACAAGTAAACGC
AACTCCCCACGAAACG-1	CCTAGCAATT	TCGGCATAGACGAGCTGTACAAGTAAACGC
CACAGTAGTGTAACGG-1	CCTATTCTCA	TCGGCATGGACGAGCTGTACAAGTAAACGC
CTCGGAGCAAGACGTG-1	CCTCAAATCA	TCGGCATGGACGAGCTGTACAAGTAAACGC
ACTTGTTAGCAGATCG-1	CCTCACGATG	TCGGCATGGACGAGCTGTACAAGTAAACGC
GATGCTAAGAATAGGG-1	CCTCAGACTC	TCGGCATGGACGAGCTGTACAAGTAAACGC
CGACTTCCAGAGCCAA-1	CCTCAGTAAG	TCGGCATGGACGAGCTGTACAAGTAAACGC
AACTCCCCACAGTCGC-1	CCTCATTGTT	------------------------------
ATTACTCGTCACACGC-1	CCTCCAATGT	------------------------------
TGAGCATCAGCTCCGA-1	CCTCCAGATT	TCGGCATGGACGAGCTGTACAAGTAAACGC
TAAGTGCCAGGGTATG-1	CCTCCCTAGG	---------------------------CGC
GACAGAGAGTATCTCG-1	CCTCCGATCA	TCGGCATGGACGAGCTGTACAAGTAAACGC
GTTCATTAGCCGCCTA-1	CCTCCTCATT	TCGGCATGGACGAGCTGTACAAGTAAACGC
TCGGGACAGAATAGGG-1	CCTCCTTCGA	TCGGCATGGACGAGCTGTACAAGTAAACGC
CGATGGCAGAGGACGG-1	CCTCGCGTGT	TCGGCATGGACGAGCTGTACAAGTAAACGC
GAAACTCAGTACACCT-1	CCTCGCTTTT	------------------------------
TCAGATGAGCTGATAA-1	CCTCGGAAGA	TCGGCATGGACGAGCTGTACAAGTAAACGC
CCACTACAGGGAAACA-1	CCTCGTCTGA	---------------------TCGGCATGG
CCTTACGAGCAGCCTC-1	CCTCTCAACG	TCGGCATGGACGAGCTGTACAAG-------
AAAGTAGAGCTACCTA-1	CCTCTCCTCC	TCGGCATGGACGAGCTGTACAAGTAAACGC
ATCATCTCACAGGTTT-1	CCTCTGAACT	------------------------------
CGATGGCCAATCTGCA-1	CCTCTGAGAG	TCGGCATGGACGAGCTGTACAAGTAAACGC
CCCAGTTGTCTGGTCG-1	CCTCTTTCGT	TCGGCATGGACGAGCTGTACAAGTAAACGC
GTGAAGGCACGGCCAT-1	CCTGAGGTGG	------------------------------
ACGGCCATCGGCGGTT-1	CCTGAGTCCA	TCGGCATGGACGAGCTGTACAAGTAAACGC
CCCAATCAGTGACATA-1	CCTGATTCTG	-------------GCTGTACAAGTAAACGC
GTACTCCGTCGATTGT-1	CCTGATTGCG	TCGGCATGGACGAGCTGTACAAGTAAACGC
TACCTATAGGCGCTCT-1	CCTGCATTAG	TCGGCATGGACGAGCTGTACAAGTAAACGC
TCAGATGGTATAGGTA-1	CCTGGCATAC	TCGGCATGGACGAGCTGTACAAGTAAACGC
TAGTGGTGTCTCAACA-1	CCTGGGCTTG	-------------------------AACGC
GTTACAGGTGTAACGG-1	CCTGGGTGGC	TCGGCATGGACGAGCTGTACAAGTAAACGC
ACACCCTGTCGTGGCT-1	CCTGTCAGTG	TCGGCATGGACGAGCTGTACAAGTAAACGC
GCTCCTAGTTCGGGCT-1	CCTGTCCATT	TCGGCATGGACGAGCTGTACAAGTAAACGC
CCTACCAGTGATAAAC-1	CCTGTCTTCT	TCGGCATGGACGAGCTGTACAAGTAAACGC
TTGCGTCAGAGATGAG-1	CCTTAACGTA	TCGGCATGGACGAGCTGTACAAGTAAACGC
CCATGTCTCAACGGGA-1	CCTTAATTTT	TCGGCATGGACGAGCTGTACAAGTAAACGC
ACGCCGATCAACGAAA-1	CCTTACTGAA	TCGGCATGGACGAGCTGTACAAGTAAACGC
AGGCCACGTGGCGAAT-1	CCTTATCGTT	TCGGCATGGACGAGCTGTACAAGTAAACGC
CTGCCTAAGTGTCCCG-1	CCTTATGAAT	------------------------------
CTAGCCTGTGCCTGTG-1	CCTTGTGCCA	TCGGCATGGACGAGCTGTACAAGTAAACGC
CTCGAGGTCCATGAAC-1	CCTTTATTCC	----CATGGACGAGCTGTACAAGTAAACGC
TCTCATAGTCTCATCC-1	CCTTTGCATG	------------------------------
CCAATCCAGCTGCCCA-1	CCTTTTGCTT	TCGGCATGGACGAGCTGTACAAGTAAACGC
GAACATCAGCGGATCA-1	CCTTTTGTTT	TCGGCATGGACGAGCTGTACAAGTAAACGC
GGAGCAACACGAGAGT-1	CCTTTTTAAG	------------------------------
AACTCAGCAACACGCC-1	CGAAAACCCT	TCGGCATGGACGAGCTGTACAAGTAAACGC
AGAGCGAAGCGTAGTG-1	CGAACGAATT	------------------------------
CTGAAGTAGCGAGAAA-1	CGAACGTGTT	TCGGCATGGACGAGCTGTACAAGTAAACGC
CGTTCTGTCAGGTAAA-1	CGAAGTTCAA	TCGGCATGGACGAGCTGTACAAGTAAACGC
CTGATAGGTAGCAAAT-1	CGAATAAAGC	------------------------------
CCTTACGTCGGATGGA-1	CGACAGTGTG	---------------TGTACAAGTAAACGC
ATCTACTCATGGGACA-1	CGACCACCAG	TCGGCATGGACGAGCTGTACAAGTAAACGC
AGATCTGGTCCATGAT-1	CGACGCGACG	TCGGCATGGACGAGCTGTACAAGTAAACGC
TGTGGTACAGCGAACA-1	CGACTGCCCG	TCGGCATGGACGAGCTGTACAAGTAAACGC
CGATGTAGTCCATGAT-1	CGAGAAACTC	------------------------------
AGGTCATGTGGTTTCA-1	CGAGACGCCT	------------------------------
GGTGAAGCATTCCTCG-1	CGAGCAGCCG	TCGGCATGGACGAGCTGTACAAGTAAACGC
ACACCGGAGACAGACC-1	CGAGCCATGT	TCGGCATGGACGAGCTGTACAAGTAAACGC
TGTTCCGCAAATCCGT-1	CGAGCGCCTG	TCGGCATGGACGATCTGTACAAGTAAACGC
ACTTTCATCTGTGCAA-1	CGAGGCGGGC	TCGGCATGGACGAGCTGTACAAGTAAACGC
CACAGTACATCTGGTA-1	CGAGTAGATT	TCGGCATGGACGAGCTGTACAAGTAAACGC
AGAGCTTGTCGCGTGT-1	CGAGTGTTTT	------------------------------
GATGAAAGTACCCAAT-1	CGATACGAGC	TCGGCATGGACGAGCTGTACAAGTAAACGC
TAGCCGGTCCACGTTC-1	CGATCAGGGT	TCGGCATGGACG------------------
ACGCCGATCTATCGCC-1	CGATGCGTGA	TCGGCATGGACGAGCTGTACAAGTAAACGC
TCGAGGCGTTCTGTTT-1	CGATGTCAAA	TCGGCATGGACGAGCTGTACAAGTAAACGC
GGATGTTTCACAATGC-1	CGATGTTCGC	TCGGCATGGACGAGCTGTACAAGTAAACGC
GGTATTGGTTACGTCA-1	CGATTTCTGC	TCGGCATGGACGAGCTGTACAAGTAAACGC
GTTCATTAGCCGCCTA-1	CGCAAGCGGG	--GGCATGGACGAGCTGTACAAGTAAACGC
CGCGGTATCCATGAAC-1	CGCACAGTGC	TCGGCATGGACGAGCTGTACAAGTAAACGC
ACCCACTGTATGAATG-1	CGCACATCAA	TCGGCATGGACGAGCTGTACAAGTAAACGC
GCGAGAAGTACTCTCC-1	CGCACATGGT	------------------------------
GCGAGAAGTACTCTCC-1	CGCACATGGT	------------------------------
TCGGGACTCGGAGGTA-1	CGCACCACGC	TCGGCATGGACG------------------
GTGCTTCTCATGTAGC-1	CGCACGGTCG	TCGGCATGGACGAGCTGTACAAGTAAACGC
CTCATTAAGGAATTAC-1	CGCACTCTGT	TCGGCATGGACGAGCTGTACAAGTAAACGC
AGCGTCGCACCCAGTG-1	CGCAGATTAG	TCGGCATGGACGAGCTGTACAAGTAAACGC
CATATGGCAAGCCATT-1	CGCAGCTCTT	TCGGCATGGACGAGCTGTACAAGTAAACGC
CAAGAAAAGTGGAGAA-1	CGCATGAAGC	TCGGCATGGACGAGCTGTACAAGTAAACGC
CAGAATCGTACAGTTC-1	CGCATTAGCC	------------------------------
AAGGCAGAGCCCGAAA-1	CGCATTGGCC	TCGGCATGGACGAGCTGTACAAGTAAACGC
AACTGGTAGATAGCAT-1	CGCCAAGGAT	------------------------------
ACTGAACTCATGTCCC-1	CGCCACGAGA	TCGGCATGGACGAGCTGTACAAGTAAACGC
TGTGTTTTCTTGTTTG-1	CGCCAGTGGA	TCGGCATGGACGAG----------------
TGTGTTTTCTTGTTTG-1	CGCCAGTGGA	TCGGCATGGACGAGCTGTACAAGTAAACGC
CAGAGAGAGAGGTAGA-1	CGCCATGAGG	------------------------------
TGGGAAGTCCCACTTG-1	CGCCCACATT	TCGGCATGGACGAGCTGTACAAGTAAACGC
TGGGAAGTCCCACTTG-1	CGCCCACATT	TCGGCATGGACGAGCTGTACAAGTAAACGC
TTAGTTCAGTTCGCAT-1	CGCCCACCCG	TCGGCATGGACGAGCTGTACAAGTAAACGC
TCCCGATTCATCTGCC-1	CGCCCTGGTT	TCGGCATGGACGAGCTGTACAAGTAAACGC
TCTTTCCTCTGGCGTG-1	CGCCTTTGTT	TCGGCATGGACGAGCTGTAC----------
TACTTGTGTTATCACG-1	CGCGATGGGC	------------------------------
CCACCTACAATTCCTT-1	CGCGCTGTAT	TCGGCATGGACGAGCTGTACAAGTAAACGC
CTCGTACAGGCAATTA-1	CGCGGACTTC	TCGGCATGGACGAGCTGTACAAGTAAACGC
GACACGCCATGGATGG-1	CGCGGTCGAA	TCGGCATGGACGAGCTGTACAAGTAAACGC
GGGATGATCAGCTTAG-1	CGCGTCTGGC	---------------------------CGC
CTAGAGTGTTTGGCGC-1	CGCGTTAAGT	------------------------------
GTACGTACAAGACGTG-1	CGCTAACGGG	TCGGCATGGACGAGCT--------------
TCGCGAGTCCTTAATC-1	CGCTACCACT	------------------------------
GCGCAGTAGAAGGTTT-1	CGCTGAGCTC	---------------------AGTAAACGC
GTACGTACAAGACGTG-1	CGCTGTTCAA	TCGGCATGGACGAGCTGTACAAGTAAACGC
TGATTTCCAGGGATTG-1	CGCTTACTAA	------------------------------
TGGTTCCCACAGCCCA-1	CGCTTGCTCT	TCGGCATGGACGAGCTGTACAAGTAAACGC
TGAGAGGAGTACATGA-1	CGCTTTATTC	TCGGCATGGACGAGCTGTACAAGTAAACGC
GTGTTAGCAGTAAGAT-1	CGGACAGACC	------------------------------
GAGGTGACAGATGGCA-1	CGGACGGGTT	TCGGCATGGACGAGCTGTACAAGTAAACGC
CTAGAGTCATGCGCAC-1	CGGAGCCTTC	TCGGCATGGACGAGCTGTACAAGTAAACGC
TCTATTGGTCAACATC-1	CGGCCCACTG	TCGGCATGGACGAGCTGTACAAGTAAACGC
GCTTGAAGTTCACGGC-1	CGGCCCTTTC	TCGGCATGGACGAGCTGTACAAGTAAACGC
TCGCGAGAGTTACGGG-1	CGGCCTCGGT	TCGGCATGGACGAGCTGTACAAGTAAACGC
TTGCCGTTCACGACTA-1	CGGCTATCCG	TCGGCATGGACGAGCTGTACAAGTAAACGC
GACTGCGTCGCTAGCG-1	CGGCTCAGAG	CCGGCATGGACGAGCTGTACAAGTAAACGC
AGTAGTCCAGCTCGAC-1	CGGCTCATGC	TCGGCATGGACGAGCTGTACAAGTAAACGC
GCATGATTCAGTTGAC-1	CGGCTGGTGG	TCGGCATGGACGAGCTGTACAAGTAAACGC
TAGTGGTAGGATGGAA-1	CGGCTGTTTT	TCGGCATGGACGAGCTGTACAAGTAAACGC
GGGCACTTCGCAGGCT-1	CGGGGCATTT	TCGGCATGGACGAGCTGTACAAGTAAACGC
GCGGGTTTCCTGCCAT-1	CGGGGTAAGA	------------------------------
TATTACCGTCCAGTGC-1	CGGTAACGTT	TCGGCATGGACGAGCTGTACAAGTAAACGC
CTGATAGGTAAGTGGC-1	CGGTACCAGC	TCGGCATGGACGAGCTGTACAAGTAAACGC
TGAGCATGTCAAACTC-1	CGGTAGCTAT	TCGGCATGGACGAGCTGTACAAGTAAACGC
CATCAGAAGGGTATCG-1	CGGTCCGGCA	------------------------------
CACCACTGTCTGGTCG-1	CGGTCTTGTT	TCGGCATGGACGAGCTGTACAAGTAAACGC
CTCGTACCACATCCGG-1	CGTAATCCTT	---GCATGGACGAGCTGTACAAGTAAACGC
CAGCCGACAAGCCATT-1	CGTACATCGA	TCGGCATGGACGACCTGTACAAGTAAACGC
CCGGGATAGGCCGAAT-1	CGTACTTGTT	TCGGCATGGACGAGCTGTACAAGTAAACGC
GGCTCGAAGATGGGTC-1	CGTAGATGTA	TCGGCATGGACGAGCTGTACAAGTAAACGC
GTACTCCCAGTTTACG-1	CGTAGCATAT	TCGGCATGGACGAGCTGTACAAGTAAACGC
CTCACACGTACTTAGC-1	CGTAGTGTCT	------------------------------
GAATAAGAGATGCCAG-1	CGTATTATCA	TCGGCATGGACGAGCTGTACAAGTAAACGC
CATATGGGTCGAGTTT-1	CGTCACATTC	TCGGCATGGACGAGCTGTACAAGTAAACGC
TTGAACGCAGACTCGC-1	CGTCACTTCA	TCGGCATGGACGAGCTGTACAAGTAAACGC
AAGGTTCAGATGGCGT-1	CGTCATTTGT	TCGGCATGGACGAGCTGTACAAGTAAACGC
AGCAGCCTCCGAATGT-1	CGTCCACAGC	------------------------------
AACTGGTCACATTCGA-1	CGTCCCCGCT	TCGGCATGGACGAGCTGTACAAGTAAACGC
CTGTTTACACGGATAG-1	CGTCGACCAT	TCGGCATGGACGAGCTGTACAAGTAAACGC
CGGTTAAGTACATGTC-1	CGTCGGTCCA	---------------TGTACAAGTAAAAGC
TGCGCAGTCTTGAGGT-1	CGTCGTACGA	TCGGCATGGACGAGCTGTACAAGTAAACGC
AAGCCGCTCCTAGTGA-1	CGTCGTATAA	TCGGCATGGACGAGCTGTACAAGTAAACGC
TAGTGGTTCCTTAATC-1	CGTCTAGTAC	TCGGCATGGACGAGCTGTACAAGTAAACGC
AGGGAGTCACCAGATT-1	CGTCTCGCTG	------------------------------
GATCGCGAGTGGACGT-1	CGTGAAATAG	TCGGCATGGACGAGCTGTACAAGTAAACGC
CCGTACTGTAAAGGAG-1	CGTGCACGCC	TCGGCATGGACGAGCTGTACAAGTAAACGC
GGGATGATCAGCTTAG-1	CGTGGTCGAT	---GCATGGACGAGCTGTACAAGTAAACGC
CGTGTAATCCTAGAAC-1	CGTGTATCAT	------------------------------
GCATGATGTGCGATAG-1	CGTTACGGTT	TCGGCATGGACGAGCTGTACAAGTAAACGC
GGACAGACAACGCACC-1	CGTTACTGTT	TCGGCATGGACGAGCTGTACAAGTAAACGC
TGTGGTACAGCTCGCA-1	CGTTATCGCC	------------------------------
ACTGATGTCGCCAGCA-1	CGTTCCGAGC	TCGGCATGGACGAGCTGTACAAGTAAACGC
GACGCGTAGCAGCCTC-1	CGTTCGTGCT	TCGGCATGGACGAGCTGTACAAGTAAACGC
TATTACCCACGCCAGT-1	CGTTCTAGTC	TCGGCATGGACGAGCTGTACAAGTAAACGC
GTCGGGTTCCGTTGCT-1	CGTTGCGTTA	TCGGCATGGACGAGCTGTACAAGTAAACGC
TGGGAAGAGTCGCCGT-1	CGTTGTACGA	------------------------------
GAATGAAAGCGAAGGG-1	CGTTTGCTTG	TCGGCATGGACGAGCTGTA-----------
ACATCAGAGACACGAC-1	CGTTTTCGTT	TCGGCATGGACGAGCTGTACAAGTAAACGC
AGATTGCTCCACGTGG-1	CGTTTTGCCT	TCGGCATGGACG------------------
GGTGCGTGTCAGAAGC-1	CGTTTTTGCG	TCGGCATGGACGAGCTGTACAAGTAAACGC
CTGTTTACAATAGAGT-1	CTAAACATAG	TCGGCATGGACGAGCTGTACAAGTAAACGC
TAGGCATAGACTACAA-1	CTAAACTCTA	TCGGCATGGACGAGCTGTACAAGTAAACGC
CTCGAGGGTCGCTTCT-1	CTAAATGAAT	TCGGCATGGACGAGCTGTACAAGTAAACGC
TTCTCCTCAGACAAAT-1	CTAACGTATC	TCGGCATGGACGAGCTGTAC----------
ACGAGCCCAAACCCAT-1	CTAAGCAGAT	------------------------------
CACACAAGTACCGAGA-1	CTAAGGGTTT	------------------------------
CCTTACGAGTTAACGA-1	CTAATTAATG	------------------------------
GGACAAGTCAGGCGAA-1	CTAATTACCT	TCGGCATGGACGAGCTGTACAAGTAAACGC
TCCACACAGTAATCCC-1	CTAATTATAA	TCGGCATGGACGAGCTGTACAAGTAAACGC
AACCGCGAGTGTCCAT-1	CTAATTTGAT	------------------------------
CCTACACTCCCTTGCA-1	CTACAGCGCC	TCGGCATGGACGAGCTGTACAAGTAAACGC
TGCTGCTCAGCTCGCA-1	CTACATCGGA	TCGGCATGGACGAGCTGTACAAGTAAAC--
AACACGTAGACTCGGA-1	CTACATCTAG	TCGGCATGGACG------------------
GAACCTACAGGTCCAC-1	CTACCCAAAG	TCGGCATGGACGAGCTGTACAAGTAAACGC
TCCACACCAAAGTCAA-1	CTACCCCCCG	TCGGCATGGACGAGCTGTACAA--------
TAGCCGGCAAGGGTCA-1	CTACGATAAT	TCGGCATGGACGAGCTGTACAAGTAAACGC
CAACTAGAGTCCAGGA-1	CTACGTTTTG	------------------------------
CAGCGACTCTATGTGG-1	CTACTAAGGT	------------------------------
AGACGTTGTACCGCTG-1	CTACTACCCG	------------------------------
ACTATCTTCCGTTGTC-1	CTACTTTAGT	TCGGCATGGACGAGCTGTACAAGTAAACGC
CCTACCAGTGATAAAC-1	CTAGAACGGC	TCGGCATGGACGAGCTGTACAAGTAAACGC
CATGACAAGTAGCCGA-1	CTAGACGTGT	------------------------------
CTAGCCTGTGCCTGTG-1	CTAGCAAGGG	TCGGCATGGACGAGCTGTACAAGTAAACGC
GTCATTTTCATCGCTC-1	CTAGCCCGCC	------------------------------
GTCATTTCATGGTTGT-1	CTAGCCGCAC	TCGGCATGGACGAGCTGTACAAGTAAACGC
CAGATCAGTTAAAGTG-1	CTAGCCTTAG	-----------------------------C
ACGATGTAGTCATGCT-1	CTAGGAACCG	TCGGCATGGACGAGCTGTACAAG-------
TCTCTAAGTTTAGGAA-1	CTAGGACACA	TCGGCATGGACGAGCTGTACAAGTAAACGC
CTCGTCATCCCATTAT-1	CTAGGCCATG	TCGGCATGGACGAGCTGTACAAGTAAACGC
CCATTCGTCATCATTC-1	CTAGGCTTTC	TCGGCATGGACGAG----------------
TGCGTGGTCCAAGCCG-1	CTAGGGTGTT	TCGGCATGGACGAGCTGTACAAGTAAACGC
GTTCGGGAGCCACGCT-1	CTAGGGTTAT	TAGACATGAACGAGCTGTACAAGTAAACGC
GCCAAATAGCCGGTAA-1	CTAGGGTTTT	TCGGCATGGACGAGCTGTACAAGTAAACGC
GATTCAGTCCGCATCT-1	CTAGTAATGT	TCGGCATGGACGAGCTGTACAAGTAAACGC
GGGAATGTCGGCGGTT-1	CTAGTATATA	TCGGCATGGACGAGCTGTACAAGTAAACGC
AGCTCCTGTAAAGTCA-1	CTAGTGATCC	------------------------------
TAGTGGTCACGTGAGA-1	CTATACATTA	------------------------------
GTACGTAAGATGTGGC-1	CTATACCTTC	TCGGCATGGACGAGCTGTACAAGTAAACGC
CCTTACGAGGAGCGTT-1	CTATAGGATT	------------------------------
GCTCCTACACCAGTTA-1	CTATAGTGAG	TCGGCATGGACGAGCTGTACAAGTAAACGC
TCCACACAGATGTTAG-1	CTATATATGG	TCGGCATGGACGAGCTGTACAAGTAAACGC
GGCTGGTTCCGCATAA-1	CTATATGTGA	------------------------------
GACGGCTTCGTCGTTC-1	CTATCCAAGG	TCGGCATGGACGAGCTGTACAAGTAAACGC
TGGGAAGGTTTGACTG-1	CTATGATGTT	------------------------------
GCACTCTCAGTGAGTG-1	CTATGGTGTT	TCGGCATGGACGAGCTGTACAAGTAAACGC
TCTTTCCCAGATGGGT-1	CTATTCGGAG	-------GGACGAGCTGTACAAGTAAACGC
CACAGTAGTCGGCTCA-1	CTATTTTTTT	------------------------------
GTTCGGGGTGGGTATG-1	CTCAAAAGGT	TCGGCATGGACGAGC---------------
AAGGCAGGTTCGCGAC-1	CTCAAACACG	TCGGCATGGACGAGCTGTACAAGTAAACGC
ACAGCTACATGGTCTA-1	CTCAAACGGT	TCGGCATGGACGAGCTGTACAAGTAAACGC
AGAGCTTTCCTTGACC-1	CTCAAAGCAT	---------ACGAGCTGTACAAGTAAACGC
CAGCCGACACTCAGGC-1	CTCAAATATC	TCGGCATGGACGAGCTGTACAAGTAAACGC
CATCGAACATTGCGGC-1	CTCAACGGCG	------------------------------
ATCTACTGTAGGCTGA-1	CTCAAGTGAA	TCGGCATGGACGAGCTGTACAAGTAAACGC
ACCTTTAAGCTGAACG-1	CTCAATACTG	TCGGCATGGACGAGCTGTACAAGTAAACGC
GTACGTATCACGCATA-1	CTCACAGGGT	TCGGCATGGACGAGCTGTACAAGTA-----
AGCTCTCGTCGAAAGC-1	CTCAGCTCTT	TCGGCATGGACGAGCTGTACAAGTAAACGC
TTTCCTCTCGCTTAGA-1	CTCAGCTGTG	------------------------------
ACGAGGACATCCGTGG-1	CTCAGGATTG	TCGGCATGGACGAGCTGTACAAGTAAACGC
TGGCCAGAGTGGAGTC-1	CTCAGGTGTT	TCGGCATGGACGAGCTGTACAAGTAAACGC
ACTATCTTCCCTAACC-1	CTCATGAGAG	TCGGCATGGACGAGCTGTACAAGTAAACGC
GGTATTGTCATGTGGT-1	CTCATGCGAT	TCGGCATGGACGAGCTGTACAAGTAAACGC
TACCTTAAGTACGCGA-1	CTCCAAACGG	-----------GAGCTGTACAAGTAAACGC
GCTTCCAGTCAGGACA-1	CTCCAAATCA	------------------------AAACGC
CATTATCCAAGAGGCT-1	CTCCAATATT	----------------GTACAAGTAAACGC
CAGAGAGGTCAGGACA-1	CTCCACCGGG	TCGGCATGGACGAGCTGTACAAGTAAACGC
ACACCCTAGTCAATAG-1	CTCCACTGGC	------------------------------
GTCCTCAGTCATCCCT-1	CTCCACTTAC	TCGGCATGGACGAGCTGTACAAGTAAACGC
CAAGGCCAGTTAGCGG-1	CTCCCAAGAT	TCGGCATGGACGAGCTGTACAAGTAAACGC
GTTACAGCACATCCAA-1	CTCCCATACA	TCGGCATGG---------------------
GAGCAGAAGATTACCC-1	CTCCGTATCC	TCGGCATAGACGAGCTGTACAAGTAAACGC
GTGCTTCCAGTCAGAG-1	CTCCTCCGAT	TCGGCATGGACGAGCTGTACAAGTAAACGC
ACGGAGATCAACCAAC-1	CTCCTTATGT	------------------------------
CATCAAGCAAAGCAAT-1	CTCCTTTTGT	TCGGCATGGACGAGCTGTACAAGTAAACGC
CTGAAGTTCGGCGGTT-1	CTCCTTTTTG	-------------------------AACGC
TTTACTGCATCCCATC-1	CTCGACATCA	TCGGCATGGACGAGCTGTACAAGTAAACGC
GCATGCGTCAACGAAA-1	CTCGCCATGT	TCGGCATGGACGAGCTGTACAAGTAAACGC
GACTGCGTCGCTAGCG-1	CTCGCTTCTG	TCGGCATGGACGAGCTGTACAAGTAAACGC
CAGCGACTCTATGTGG-1	CTCGGCATGC	TCGGCATGGACGAGCTGTACAAGTAAACGC
ACAGCTAGTCACAAGG-1	CTCGTAGGCG	---------------------------CGC
AGGTCATCACTATCTT-1	CTCGTATGTA	TCGGCATGGACGAGCTGTACAAGTAAACGC
GCGGGTTCATCACGAT-1	CTCTATCTGG	TCGGCATGGACGAGCTGTACA---------
GAATAAGCACATGGGA-1	CTCTCACGAG	TCGGCATGGACGAGCTGTACAAGTAAACGC
CACATTTAGTGGGCTA-1	CTCTCAGGCC	TCGGCATGGACGAGCTGTACAAGTAAACGC
ACGTCAAAGTTACCCA-1	CTCTCCCTCG	TCGGCATGGACGAGCTGTACAAGTAAACGC
ACTGTCCGTAAGTGGC-1	CTCTCTAAGA	TCGGCATGGACGAGCTGTACAAGTAAACGC
CCATGTCTCAACGGGA-1	CTCTCTTGGT	TCGGCATGGACGAGCTGTACAAGTAAACGC
TGGTTAGGTCCCTACT-1	CTCTCTTGTG	TCGGCATGGACGAGCTGTACAAGTAAACGC
AGGGAGTAGCGATTCT-1	CTCTGACTAG	TCGGCATGGACGAGCTGTACAAGTAAACGC
GCGCGATCACAGAGGT-1	CTCTGGAAAG	------------------------------
CACCTTGCAAATTGCC-1	CTCTTAATTG	TCGGCATGGACGAGCTGTACAAGTAAACGC
ACTGATGGTTCAGTAC-1	CTCTTAGTGT	TCGGCATGGACGAGCTGTACAAGTAAACGC
CCACGGAAGCCAGAAC-1	CTCTTATGAA	TCGGCATGGACGAGCTGTACAAGTAAACGC
CCGTACTGTAAAGGAG-1	CTCTTATTAT	TCGGCATGGACGAGCTGTACAAGTAAACGC
CATCGAACACTAGTAC-1	CTCTTCGTCT	TCGGCATGGACGAGCTGTACAAGTAAACGC
TCTGGAATCGGAAATA-1	CTCTTTTGGC	TCGGCATGGACGAGCTGTACAAGTAAACGC
TAGCCGGCAAGGGTCA-1	CTCTTTTGTG	------------------------------
TACTTACTCACGAAGG-1	CTCTTTTTGA	TCGGCAGGGACCAGCTGTACAAGTAAACGC
GGATTACAGGTGCTAG-1	CTGAAAGTTT	TCGGCATGGACGAGCTGTACAAGTAAACGC
GCTCCTAAGACCTTTG-1	CTGACCGATC	TCGGCATGGACGAGCTGTACAAGTAAACGC
GGGAGATGTTCAACCA-1	CTGAGACGTT	TCGGCATGGACGAGCTGTACAAGTAAACGC
CACATTTTCTTGTACT-1	CTGAGATGAC	TCGGCATGGACGAGCTGTACAAGTAAACGC
GACCTGGAGAACAACT-1	CTGAGATTTT	TCGGCATGGACGAGCTGTACAAGTAAACGC
TGGTTAGCAGTGGAGT-1	CTGAGTTGGG	TCGGCATGGACGAGCTGTGCAAGGAAACGC
GCACTCTTCTCAAACG-1	CTGCACTTTT	TCGGCATGGACGAGCTGTACAAGTAAACGC
ACCCACTGTTACTGAC-1	CTGCAGCGCG	-----------------------------C
CGTTAGAGTGGAAAGA-1	CTGCCCAGCA	TCGGCATGGACGAGCTGTACAAGTAAACGC
GGACAGACATGAACCT-1	CTGCCCATTT	TCGGCATGGACGAGCTGTACAAGTAAACGC
TACTCATGTAGCCTAT-1	CTGCCCGTCG	---------------------------CGC
TTGTAGGTCGTCGTTC-1	CTGCCGGAAA	TCGGCATGGACGAGCTGTACAAGTAAACGC
CGAGAAGAGATCTGAA-1	CTGCGAGGAA	TCGGCATGGACGAGCTGTACAAGTAAACGC
GGCTGGTTCCGCATAA-1	CTGCTCATTA	------------------------------
CAGCTGGGTTAAAGAC-1	CTGCTTACAT	-------------GCTGTACAAGTAAACGC
GATGAAAGTACCCAAT-1	CTGCTTTAAT	TCGGCATGGACGAGCTGTACAAGTAAACGC
GGACAGACATGAACCT-1	CTGGAAGGCT	TCGGCATGGACGAGCTGTACAAGTAAACGC
CTACGTCAGCTGCGAA-1	CTGGATGAAA	------------------------------
TCTCTAAGTCGGATCC-1	CTGGCCCAAT	TCGGCATGGACGAGCTGTACAAGTAAACGC
GTACTCCAGACTTGAA-1	CTGGGATGGT	TCGGCATGGACGAGCTGTACAAGTAAACGC
CCATTCGTCAGAGGTG-1	CTGGGTCCGG	TCGGCATGGACGAGCTGTACAAGTAAACGC
ATTACTCCACTATCTT-1	CTGGGTTTAC	TCGGCATGGACGAGCTGTACAAGTAAACGC
GTGAAGGAGTGAACGC-1	CTGGTAGAAG	TCGGCATGGACGAGCTGTACAAGTAAACGC
ATGAGGGTCGGAGCAA-1	CTGGTATGGT	TCGGCATGGACGAGCTGTACAAGTAAACGC
GCATGCGCAAATCCGT-1	CTGGTCTCCG	------------------------------
TGAGAGGTCTGCAAGT-1	CTGGTCTGTA	------------------------------
TGTGTTTTCCACGTGG-1	CTGGTTAACA	TCGGCATGGACGAGCTGTACAAGTAAACGC
TTAGGACGTGGTACAG-1	CTGGTTCCTA	TCGGCATGGACGAGCTGTACAAGTAAACGC
CACATAGGTAGCTTGT-1	CTGTACGGCG	TCGGCATGGACGAGCTGTACAAGTAAACGC
GATCTAGTCCTATTCA-1	CTGTATTGAT	--------------------AAGTAAACGC
CGAGAAGCATCTGGTA-1	CTGTATTTCT	-------------------CAAGTAAACGC
CCGTACTTCCAAACAC-1	CTGTCCAGAG	------------------------------
GAACCTACATGTAGTC-1	CTGTCGAGTT	TCGGCATGGACGAGCTGTACAAGTAAACGC
TGCGTGGTCCAAGCCG-1	CTGTTCATAT	TCGGCATGGACGAGCTGTACAAGTAAAC--
CATGCCTAGACACTAA-1	CTGTTCCTAA	TCGGCATGGACGAGCTGTACAAGTAAACGC
GACGTGCGTACCGGCT-1	CTGTTTTGCG	TCGGCATGGACGAGCTGTACAAGTAAACGC
GTTCATTTCCAAAGTC-1	CTGTTTTTCG	TCGGCATGGACGAGCTGTACAAGTAAACGC
CATATTCAGTCAAGGC-1	CTTAACTTGT	TCGGCATGGACGAGCTGTACAAGTAAACGC
TAGAGCTGTTGCGCAC-1	CTTAAGAGTT	----------------GTACAAGTAAACGC
TGCACCTAGCCACGCT-1	CTTACGCTGT	------------------------------
TTTGGTTAGCTACCTA-1	CTTACTATGT	TCGGCATGGACGAGCTGTACAAGTAAACGC
GACGTGCTCCTCCTAG-1	CTTACTGATT	------------------------------
CCAATCCAGTGAAGAG-1	CTTAGACAGG	TCGGCATGGACGAGCTGTACAAGTAAACGC
TAGTTGGGTGAGTATA-1	CTTAGATTAG	TCGGCATGGACGAGCTGTACAAGTAAACGC
TAGACCATCCGAATGT-1	CTTAGTGGAA	---GCATGGACGAGCTGTACAAGTAAACGC
CCACGGACACACCGAC-1	CTTATATGGG	TCGGCATGGACGAGCTGTACAAGTAAACGC
TGTGGTAAGTGAACAT-1	CTTATATTGA	TCGGCATGGACGAGCTGTACAAGTAAACGC
TCGGTAAAGCTAACTC-1	CTTATCCCGG	TCGGCATGGACGAGCTGTACAAGTAAACGC
TCGAGGCCAATCTGCA-1	CTTATCGCCG	TCGGCATGGACGAGCTGTACAAGTAAACGC
GATCGTAAGCCAGGAT-1	CTTATTCATA	TCGGCATGGACGAGCTGTACAAGTAAACGC
TGTGGTATCAGTCAGT-1	CTTATTTTGG	TCGGCATGGACGAGCTGTACAAGTAAACGC
CCTAAAGTCATAAAGG-1	CTTCAAGTGT	TCGGCATGGACGAGCTGTACAAGTAAACGC
AGCTCCTGTAAAGTCA-1	CTTCAAGTTC	TCGGCATGGACGAGCTGTACAAG-------
TGGCGCAAGACTAGAT-1	CTTCAATTTC	------------------------------
CACCAGGCAAACGTGG-1	CTTCATAGTG	---GCATGGACGAGCTGTACAAGTAAACGC
GTGGGTCAGATACACA-1	CTTCCGTACT	------------------------------
CTGCCTACATGCCTTC-1	CTTCCTAGTG	TCGGCATGGACGAGCTGTACAAGTAAACGC
GATCGCGAGAGCTGCA-1	CTTCCTTCAA	TCGGCATGGACGAGCTGTACAAGTAAACGC
TACTTGTGTTATCACG-1	CTTCGATTCA	TCGGCATGGACGAGCTGGACAAGTAAACGC
GACCTGGAGCGTGTCC-1	CTTCTACTAT	TCAGCATGGACGAGCTGTACAAGTAAACGC
CCTACCAAGGCCCTCA-1	CTTCTATATA	TCGGCATGGACGAGCTGTACAAGTAAAAGC
GGAAAGCAGAACAATC-1	CTTCTGCACC	TCGGCATGGACGAGCTGTACAAGTAAACGC
AGGCCGTGTTATGTGC-1	CTTCTGTATT	TCGGCATGGACGAGCTGTACAAGTAAACGC
ACTATCTTCCGTTGTC-1	CTTGAAGTAT	-CGGCATGGACGAGCTGTACAAGTAAACGC
GACGGCTAGTGTTAGA-1	CTTGAGCCAC	TCGGCATGGACGAGCTGTACAAGTAAACGC
GAATGAAGTACCGCTG-1	CTTGAGTAAA	------------------------------
CGTCTACAGCTTCGCG-1	CTTGATTCGG	TCGGCATGGACGAGCTGTACA---------
ATGGGAGGTGAGTATA-1	CTTGCCAGTC	--------GACGAGCTGTACAAGTAAACGC
GATGAAACAGATCCAT-1	CTTGCTGACA	TCGGCATGGACGAGCTGTACAAGTAAACGC
TTATGCTTCCACGTTC-1	CTTGGCCACT	TCGGCATGGACGAGCTGTACAAGTAAACGC
GCTTGAATCATCATTC-1	CTTGGGCCAA	------------------------------
TCAGCTCGTTCTGGTA-1	CTTGGGCGGT	TCGGCAAGGACGAGCTGTACAAGTAAACGC
CTGATCCGTCACCTAA-1	CTTGGTAGGA	TCGGCATGGACGAGCTGTACAAGTAAACGC
TGGGAAGAGTTGCAGG-1	CTTGGTCGTA	TCGGCATGGACGAGCTGTACAAGTAAACGC
AACCGCGGTGATGATA-1	CTTGTTCAGT	---------------------------CGC
CTGCCTAAGTGTCCCG-1	CTTGTTGTGA	TCGGCATGGACGAGCTGTACAAGTAAACGC
GTTACAGAGTTGAGTA-1	CTTGTTTTTT	TCGGCATGGACGAGCTGTACAAGTAAACGC
CTAAGACAGTAGGTGC-1	CTTTACTTTG	TCGGCATGGACGAGCTGTACAAGTAAACGC
CGTGTCTTCCCTTGCA-1	CTTTAGGGTT	TCGGCATGGACGAGCTGTACAAGTAAACGC
CCATGTCTCTCCTATA-1	CTTTATCCGC	------------------------------
TACACGAAGGGTATCG-1	CTTTCATGAG	TCGGCATGGACGAGCTGTACAAGTAAACGC
TACCTTAAGTACGCGA-1	CTTTCCTCTG	------------------------------
ATTATCCCACACGCTG-1	CTTTCGGCTT	TCGGCATGGA--------------------
CGGTTAAGTTACCGAT-1	CTTTCGGGAT	TCGGCATGGACGAGCTGTACAAGTAAACGC
CAAGTTGGTTAGGGTG-1	CTTTCTGCCT	TCGGCATGGACGAGCTGTACAAGTAAACGC
TCAGGTACATTGGCGC-1	CTTTCTTGAG	-----------GAGCTGTACAAGTAAACGC
GGAACTTCAAGAAGAG-1	CTTTCTTTTC	------------------------------
TAGCCGGTCCACGTTC-1	CTTTGATCCG	TCGGCATGGACGAGCTGTACAAGTAAACGC
CAGATCACATCGACGC-1	CTTTGCAATA	TCGGCATGGACGAGCTGTACAAG-------
TACTCATTCGGAAATA-1	CTTTGCCCGG	------------AGCTGTACAAGTAAACGC
GACGGCTGTATCTGCA-1	CTTTTATCAC	TCGGCATGGACGAGCTGTACAAGTAAACGC
GCGCGATCATTCTCAT-1	CTTTTCCATT	---------------------AGTAAACGC
ATCTGCCTCACTGGGC-1	CTTTTCGCGA	TCGGCATGGACGAGCTGTACAAGTAAACGC
CTAAGACCATGGATGG-1	CTTTTCTGTA	TCGGCATGGACGAGCTGTACAAGTAAACGC
ACCTTTACACGGTTTA-1	CTTTTGCCAT	TCGGCATGGAC-------------------
GCAATCACATTAACCG-1	CTTTTGTGGC	TCGGCATGGACGAGCTGTACAAGTAAACGC
CCAATCCCACATGTGT-1	CTTTTGTTGG	TCGGCATGGACGAGCTGTACAAGTAAACGC
TACACGACAGTCAGCC-1	CTTTTTGGCT	TCGGCATGGACGAGCTGTACAAGTAAACGC
ACTGTCCTCCGTTGTC-1	CTTTTTGTTC	TCGGCATGGACGAGCTGTACAAGTAAACGC
TTGCGTCGTATCACCA-1	GAAAAAACAT	TCGGCATGGACGAGCTGTACATGTAAACGC
AATCGGTCATCCGGGT-1	GAAACAATAT	-------GGACGAGCTGTACAAGTAAACGC
CGAGCCAAGGCAATTA-1	GAAACACGGA	TCGGCATGGACGAGCTGTACAAGTAAACGC
TGGTTAGCAGTGGAGT-1	GAAAGTTGTG	------------------------------
ACGCAGCTCGTATCAG-1	GAAATCGAGC	TCGGCATGGACGAGCTGTACAAGTAAACGC
CTGTTTACACGGATAG-1	GAACAACTCT	-------------------CAAGTAAACGC
TGAGAGGAGTACATGA-1	GAACCCCCAC	TCGGCATGGACGAGCTGTACAA--------
AGCTCCTAGAAGGACA-1	GAACCGTAAG	TCGGCATGGACGAGCTGTACAAGTAAACGC
AGCGGTCGTAGATTAG-1	GAACCTAGTC	------------------------------
GCGAGAAGTACTCTCC-1	GAACGACTTC	TCGGCATGGACGAGCTGTACAAGTAAACGC
CTCTGGTAGCTAGCCC-1	GAACGCACTC	------------------------------
TCAGGATTCTGGTGTA-1	GAACGGAGAC	------------------------------
CAGCCGAAGCAATCTC-1	GAACGGAGTT	TCGGCATGGACGAGCTGTACAAGTAAACGC
GCGAGAATCCTCGCAT-1	GAACTACATT	TCGGCATGGACGAGCTGTACAAGTAAACGC
AGAGCTTGTCGCTTTC-1	GAACTGCATG	TCGGCATGGACGAGCTGTACAAGTAAACGC
ATTGGTGTCTTTCCTC-1	GAACTTGTGA	------------------------------
GCGACCATCGAGCCCA-1	GAAGCGCACG	------------------------------
TAAGTGCCAAGCCCAC-1	GAAGGGACTA	------------------------------
TCGTACCGTGTTGAGG-1	GAAGGTTGTA	------------------------------
TTTACTGCAACTGCTA-1	GAAGTTCTGT	------------------------------
TCAACGATCACATAGC-1	GAATAACTGT	TCGGCATGGACGAGCTGTACAAGTAAACGC
CATATGGCAAGCCATT-1	GAATACACGA	------------------------------
TGAGCATTCCTAGTGA-1	GAATATAACT	TCGGCATGGACGAGCTGTACAAGTAAACGC
TGAAAGACAGCCAGAA-1	GAATATGCTC	TCAGAATAGACAAGATGTACAAGTAAACAC
ACTATCTCATCGATGT-1	GAATATTTGA	TCGGCATGGACGAGCTGTACAAGTAAACGC
TCAATCTAGACACTAA-1	GAATCGAGGT	------------------------------
TAAACCGCACCGTTGG-1	GAATGAGGGC	------------------------------
TGTATTCCACACAGAG-1	GAATGCTAGA	------------------------------
TCAGCTCCAGTCACTA-1	GAATGTGAAG	TCGGCATGGACGAGCTGTACAAGTAAACGC
ACCCACTCAATCACAC-1	GAATGTTATA	TCGGCATGGACGAGCTGTACAAGTAAACGC
TAAGCGTGTTTCGCTC-1	GAATTAAATC	TCGGCATGGACGAGCTGTACAAGTAAACGC
CCATTCGTCAGAGGTG-1	GAATTAGGTT	TCGGCATGGACGAGCTGTACAAGTAAACGC
CTGAAACTCTTATCTG-1	GACACCGTGA	TCGGCATGGACGAGCTGTACAAGTAAACGC
GACTAACGTTAAGACA-1	GACACGGATT	------------------------------
AACTCCCCACGAAACG-1	GACAGCGCGT	TCGGCATGGACGAGCTGTACAAGTAAACGC
TGTTCCGCAAAGTCAA-1	GACAGCTACA	------------------------------
CGGACGTTCGGAAACG-1	GACAGCTCTT	TCGGCATGGACGAGCTGTACAAGTAAACGC
CTACGTCCACAGCCCA-1	GACAGTCTTT	TCGGCATGGACGAGCTGTACAAGTAAACGC
CAAGAAATCGCAAACT-1	GACATCCGGC	TCGGCATGGACGAGCTGTACAAGTAAACGC
ATAGACCGTAGCGTAG-1	GACATGTACC	TCGGCATGGACGAGCTGTACAAGTAAACGC
AACACGTTCTTTCCTC-1	GACCATCGTT	TCGGCATGGACGAGCTGTACAAGTAAACGC
CGTGTCTTCCCTTGCA-1	GACCATTATC	------------------------------
CGACCTTCACTTAACG-1	GACCCCTCGG	------------------------------
CCCAATCTCCGTCAAA-1	GACCCGCACG	------------------------------
TTAGTTCGTGAGTATA-1	GACCGACAGC	--------------CTGTACAAGTAAACGC
CCTTACGAGCAGCCTC-1	GACCGCCTAC	TCGGCATGGACGAGCTGTACAAGTAAACGC
GTAGGCCCAATGGAGC-1	GACGGACGGC	------------------------------
TGGTTCCCACACAGAG-1	GACTAACCCT	TCGGCATGGACGAGCTGTACAAGTAAACGC
ACGGCCATCGGCGGTT-1	GACTAAGGGT	TCGGCATGGACGAGCTGTACAAGTAAACGC
AGATCTGCAGTTCCCT-1	GACTACCCGC	TCGGCATGGACGAGCTGTACAAGTAAACGC
CCTACCAGTGCAGTAG-1	GACTCCGCGT	TCGGCATGGACGAGCTGTACAAGTAAACGC
ATCATGGCAGTTAACC-1	GACTCCTTAT	TCGGCATGGACGAGCTGTACAAGTAAACGC
ACCTTTAAGGGCACTA-1	GACTCCTTTT	TCGGCATGGACGAGCTGTACAAGTAAACGC
TGTGGTAGTAATAGCA-1	GACTCTGGGA	------------------------------
GACTAACAGTGATCGG-1	GACTGCACGC	TCGGCATGGACGAGCTGTACAAGTAAACGC
CCTATTATCTGCTGTC-1	GACTGGGCTT	TCGGCATGGACGAGCTGTACAAGTAAACGC
TGCCAAAGTGTTTGGT-1	GACTGTACTT	TCGGCATGGACGAGCTGTACAAGTAAACGC
CGAATGTCACTGTCGG-1	GACTTAATGC	TCGGCATGGACGAGCTGTACAAGTAAACGC
TACTCATAGGGCTTGA-1	GACTTATCTT	TCGGCATGGACGAGCTGTACAAGTAAACGC
GATCGCGAGTGCGTGA-1	GACTTGAGGT	TCGGCATGGACGAGCTGTACAAGTAAACGC
TGTGTTTCAAGTTAAG-1	GACTTTCCTA	------------------------------
GTGCTTCTCGGCCGAT-1	GACTTTTCCT	------------------------------
CTCACACGTTCCCTTG-1	GAGACGTGAT	TCGGCATGGACGAGCTGTACAAGTAAACGC
TAGTGGTCACGTGAGA-1	GAGACTATTT	TCGGCATGGACGAGCTGTACAAGTAAACGC
CAACTAGAGCTGCCCA-1	GAGACTCTTT	--------GACGAGCTGTACAAGTAAACGC
CTGTTTATCGCCCTTA-1	GAGAGAATTT	-------GGACGAGCTGTACAAGTAAACGC
ATCCACCGTGAACCTT-1	GAGAGGCCCT	--------------CTGTACAAGTAAACGC
TCCACACAGTCGATAA-1	GAGAGGTAAA	TCGGCATGGACGAGCTGTACAAGTAAACGC
GCGCGATCACAGAGGT-1	GAGAGTATCG	TCGGCATGGACGAGCTGTACAAGTAAACGC
CGATGGCAGAGCCTAG-1	GAGATAGTAT	TCGGCATGGACGAGCTGTACAAGTAAACGC
AGATTGCAGACCTTTG-1	GAGCCATTTT	--------GACGAGCTGTACAAGTAAACGC
ACTGTCCGTTGATTCG-1	GAGCCTGTTC	TCGGCATGGACGAGCTGTACAAGTAAACGC
CCGTGGAAGGCATGGT-1	GAGCTCCTTA	TCGGCATGGACGAGCTGTACAAGTAAACGC
GAGCAGAAGATTACCC-1	GAGCTGTATT	TCGGCATGGACGAGCTGTACAAGTAAACGC
CATATGGGTCGAGTTT-1	GAGGAATGCT	TCGGCATGGACGAGCTGTACAAGTAAACGC
CTGAAGTGTCAAACTC-1	GAGGAATGTT	TCGGCATGGACGAGCTGTACAAGTAAACGC
ACCGTAAAGAATAGGG-1	GAGGATTTGA	TCGGCATGGACGAGCTGTACAAGAAAACGC
CAGCTGGGTTAAAGAC-1	GAGGCACAGA	------------------------------
CCGTACTAGTCGATAA-1	GAGGCACAGC	TCGGCATGGACGAGCTGTACAAGTAAACGC
CAGCGACAGTTAAGTG-1	GAGGCGATAC	TCGGCATGGACGAGCTGTACAAGTAAACGC
GCCAAATCACCAACCG-1	GAGGGCATTC	TCGGCATGGACGAGCTGTACAAGTAAACGC
GGTGTTACATCATCCC-1	GAGGTCGTGA	TCGGCATGGACGAGCTGTACAAGTAAACGC
TTATGCTAGGATTCGG-1	GAGGTGGAGT	TCGGCATGGACGAGCTGTACAAGTAAACGC
ACTATCTCATCGATGT-1	GAGTAGCAAC	TCGGCATGGACGAGCTGTACAAGTAAACGC
CAGAATCGTATGGTTC-1	GAGTATTTTT	--------GACGAGCTGTACAAGTGAACGC
TCTGGAAAGAAACGCC-1	GAGTCTCAGG	------------------------------
GGCGTGTTCATCGCTC-1	GAGTTAACCA	TCGGCATGGACGAGCTGTACAAGTAAACGC
CATGACATCCACGTGG-1	GAGTTCGTCT	------------------------------
TCCACACAGATGTTAG-1	GAGTTCTCAA	---GCATGGACGAGCTGTACAAGTAAACGC
CATCGGGCAGGGTACA-1	GATAAATAGG	------------------------------
TGTCCCAGTCTTGTCC-1	GATAACTGTT	------------------------------
TGCTACCGTAAACGCG-1	GATAATTAGG	TCGGCATGGACGAGCTGTACAAGTAAACGC
GCAATCATCCACGTTC-1	GATACAAGCT	TCGGCATGGACGAGCTGTACAAGTAAACGC
CAGCCGAAGCAATCTC-1	GATACCAGCT	TCGGCATGGACGAGCTGTACAAGTAAACGC
CATTATCCAAGCCCAC-1	GATACGCACT	TCGGCATGGACGAGCTGTACAAGTAAACGC
GATTCAGCAGGGTACA-1	GATACTAGAG	TCGGCATGGACGAGCTGTACAAGTAAACGC
TAAGCGTTCGTACGGC-1	GATATAACTT	-------GGACGAGCTGTACAAGTAAACGC
CAGCTAAAGCACGCCT-1	GATATTTTAT	------------------------------
CCTACACTCTGAGGGA-1	GATCATGGGT	------------------------------
AGCATACTCGTAGGTT-1	GATCCACACA	------------------------------
GGAAAGCGTAGGCTGA-1	GATCCGCGTT	TCGGCATGGACGAGCTGTACAAGTAAACGC
AAGGAGCTCACAACGT-1	GATCCTAGTA	--------GACGAGCTGTACAAGTAAACGC
CCCAGTTAGTCGTTTG-1	GATCCTCGTT	------------------------------
TACGGGCTCGTTACAG-1	GATCGCGAGA	------------------------------
TCATTTGAGTCCCACG-1	GATCGTATGG	TCGGCATGGACGAGCTGTACAAGTAAACGC
TATGCCCTCACCCTCA-1	GATCGTCATA	----------------------GTAAACGC
GTAGGCCCAATGGAGC-1	GATCTAGTCC	TCGGCATG----------------------
GCTGCAGCAGTCGTGC-1	GATCTCATGC	TCGGCATGGACGAGCTGTACAAGTAAACGC
TCGTAGAAGATGCCTT-1	GATCTTCTGC	TCGGCATGGACGAGCTGTACAAGTAA----
AGGGTGATCCAATGGT-1	GATCTTGCTG	-----------TCGGCATGGACGAGCTGTA
AGTTGGTCAAGCTGAG-1	GATGACAAGA	------------------------------
GGCGACTTCTACTATC-1	GATGATAATT	TCGGCATGGACGAGCTGTACAAGTAAACGC
TTTCCTCTCGCTTAGA-1	GATGATTGAA	TCGGCATGGACGAGCTGTACAAGTAAACGC
CTCATTATCGGTGTTA-1	GATGCGTTTG	TCGGCATGGACGAGCTGTACAAGTAAACGC
AAGGCAGGTACATCCA-1	GATGCGTTTT	TCGGCATGGACGAGCTGTACAAGTAAACGC
TCTCATAGTGAAGGCT-1	GATGGGCGTG	---------ACGAGCTGTACAAGTAAACGC
TGACGGCCAGTATCTG-1	GATGGTAGTC	TCGGCATGGACGAGCTGTACAAGTAAACGC
CGGACACGTGCTGTAT-1	GATGTCCTTT	TCGGCATGGACGAGCTGTACAAGTAAACGC
CTCAGAAAGATGGCGT-1	GATGTCTGAA	TCGGCATGGACGAGCTGTACAAGTAAACGC
GGACGTCTCACCGGGT-1	GATGTTCTCC	TCGGCATGGACGAGCTGTACAAGTAAACGC
ACACCAAGTGTCGCTG-1	GATTAACTTC	----------------------------GC
GTCACAAAGGCCCTCA-1	GATTAGTTCC	--------GACGAGCTGTACAAGTAAACGC
CTCTAATTCGCCTGTT-1	GATTATGTCT	TCGGCATGGACGAGCTGTACAAGTAAACGC
TAGGCATGTAAGCACG-1	GATTCACCAG	TCGGCATGGACGAGCTGTACAAGTAAACGC
ACCCACTAGAGAGCTC-1	GATTCCCTGC	TCGGCATGGACGAGCTGTACAAGTAAACGC
TTGCGTCAGTCGTTTG-1	GATTCTATAT	TCGGCATGGACGAGCTGTACAAGTAAACGC
GATGCTATCGCCAAAT-1	GATTCTCACT	TCGGCATGGACGAGCTGTACAAGTAAACGC
AGGCCGTAGAGCTATA-1	GATTGGTATG	----------------GTACAAGTAAACGC
TTAGGACCAAGTACCT-1	GATTGTTTAG	TCGGCATGGACGAGCTGTACAAGTAAACGC
GATGCTAGTGTGAATA-1	GATTTAAGAA	TCGGCATGGACGAGCTGTACAAGTAAACGC
CTCGTACGTTATCGGT-1	GATTTAATGA	------------------------------
TATGCCCGTATGAATG-1	GATTTACTTG	TCGGCATGGACGAGCTGTACAAGTAAACGC
TATCTCAGTATGAATG-1	GATTTAGTCA	------------------------------
CTGCCTAAGTGTCCCG-1	GATTTCATTT	------------------------------
CAGCATAAGAGCTGGT-1	GATTTGCCTA	------------------------------
GGACAGACAATCCGAT-1	GATTTGTCTT	TCGGCATGGACGAGCTGTACAAGTAAACGC
ATCATGGTCCCTAACC-1	GCAAATATCT	------------------------------
AAAGTAGTCCCAAGTA-1	GCAAGTGCAC	TCGGCATGGACGAACTGTACAAGTAAACAA
CATCAAGTCCTAAGTG-1	GCAATAAATA	TCGGCATGGACGAGCTG-------------
GTGGGTCAGACTTGAA-1	GCAATACCGA	TCGGCATGGACGAGCTGTACAAGTAAACGC
ACACCCTAGCGCCTCA-1	GCAATGTCGT	TCGGCATGGACGAGCTGTACAAGTAAACGC
TAGCCGGCAAGGGTCA-1	GCAATTAGGA	TCGGCATGGACGAGCTGTACAAGTAAACGC
CTGATCCCATTACCTT-1	GCAATTCGCC	--------GACGAGCTGTACAAGTAAACGC
TACGGATGTCGAATCT-1	GCAATTGCGC	TCGGC-------------------------
CTGAAACGTTGTGGAG-1	GCACACCCCG	---------------------AGTAAACGC
GTCGTAATCCCATTTA-1	GCACAGTTCT	TCGGCATGGACGAGCTGTACAAGTAAACGC
GTGTGCGCATTGAGCT-1	GCACATAATT	TCGGCATGGACGAGCTGTACAAGTAAACGC
CTACACCCAGACGCAA-1	GCACCCGCTG	TCGGCATGGACGAGCTGTACAAGTAAACGC
CCTCAGTCAGGTCTCG-1	GCACCGGATA	------------------------------
CGACTTCCAGAGCCAA-1	GCACGAGCCA	------------------------------
GTAACGTCAATGGAGC-1	GCACTAATCT	----------------GTACAAGTAAACGC
TCAGATGCACAGACTT-1	GCACTCAGAT	TCGGCATGGACGAGCTGTACAAGAAAACGC
TACACGAAGGGTATCG-1	GCACTCGGTG	TCGACATGGACGAGCTGTACAAGTAAACGC
ACGTCAACAGACGCTC-1	GCACTCTTCT	TCGGCATGGACGAGCTGTACAAGTAAACGC
GGGAGATCAAGTCTAC-1	GCACTGCATA	TCGGCATGGACGAGCTGTACAAGTAAACGC
CATCAGAAGACCTTTG-1	GCACTTAAGT	TCGGCATGGACGAGCTGTACAAGTAAACGC
CATGACAAGTAGCCGA-1	GCAGAAGGCC	TCGGCATGGACGAGCTGTACAAGTAAAC--
TTATGCTTCCACGTTC-1	GCAGCATATC	------------------------------
GCACATAAGTTCCACA-1	GCAGCTACGA	TCGGCATGGACGAGCTGTACAAGTAAACGC
TTCTTAGAGGCATGTG-1	GCAGGTTATA	TCGGCATGGACGAGCTGTACAAGTAAACGC
GCACATAGTAGCGTAG-1	GCAGGTTGGT	TCGGCATGGACGAGCTGTACA---------
GAGGTGATCACGATGT-1	GCAGTACTGG	TCGGCATGGACGAGCTGTACAAGTAAACGC
AAGCCGCAGTGGGTTG-1	GCAGTGTGCG	------------------------------
ACACCGGAGAATGTTG-1	GCATAAGTTA	---------------------AGTAAACGC
ACTATCTTCCGTTGTC-1	GCATAGTCAG	------------------------------
ACGCCGAAGAGAACAG-1	GCATATATAA	TCGGCATGGACGAGCTGTACAAGTAAACGC
TAGTTGGGTCACCTAA-1	GCATATTGAG	------------------------------
TTAGGACCATCGATTG-1	GCATATTTTC	TCGGCATGGACGAGCTGTACAAGTAAACGC
GTAGTCACATCCGCGA-1	GCATCACCGA	TCGGCATGGACGAGCTGTACAAGTAAACGC
GTACTTTGTCCAAGTT-1	GCATCAGTGT	TCGGCATGGACGAGCTGTACAAGTAAACGC
GTCCTCACATGTCGAT-1	GCATCATATG	TCGGCATGGACGAGCTGTACAAGTAAACGC
GAACATCTCAGAAATG-1	GCATCTACTT	-----ATGGACGAGCTGTACAAGTAAACGC
TAGCCGGGTCTGCCAG-1	GCATGAGCTA	TCGGCATGGACGAGCTGTACAAGTAAACGC
TGTTCCGAGGCTCAGA-1	GCATGCTCTT	------------------------------
TTCTACATCAGTCCCT-1	GCATTATAGG	------------------------------
ACGAGGATCGGATGTT-1	GCATTATTTT	TCGGCATGGACGAGCTGTACAAGTAAACGC
ACACTGAAGCCATCGC-1	GCATTGGGAT	---------------------AGTAAACGC
GGGAGATTCTTAACCT-1	GCATTTTCAT	------------------------------
CTACGTCAGTCATCCA-1	GCATTTTTTT	------------------------------
TGGCCAGCAGCCAGAA-1	GCCAACTCGG	------------------------------
GAGGTGACATGCCCGA-1	GCCAGCTTAG	TCGGCATGGACGAGCTGTACAAGTAAACGC
GAGCAGACATGGTAGG-1	GCCAGGCTTT	------------------------------
TGAGGGAGTAGATTAG-1	GCCATAGATC	TCGGCATGGACGAGCTGTACAAGTAAACGC
AACTGGTAGATAGCAT-1	GCCATCGCCA	TCGGCATGGACGAGCTGTACAAGTAAACGC
TCAGATGGTTCTGAAC-1	GCCATGGAAA	TCGGCATGGACGAGCTGTACAAGTAAACGC
CAAGATCAGACGCAAC-1	GCCATTAGGC	TCGGCATGGACGAGCTGTACAAGTAAACGC
GGTGCGTCAGTGGGAT-1	GCCCAATTTG	------------------------------
GACAGAGAGTATCTCG-1	GCCCATCCAA	TCGGCATGGACGAGCTGTACAAGTAAACGC
CCGTGGACACTTCGAA-1	GCCCATCCGA	TCGGCATGGACGAGCTGTACAAGTAAACGC
AGCATACTCGTAGGTT-1	GCCCCCCTGC	TCGGCATGGACGAGCTGTACAAGTAAACGC
CCACCTACAATTCCTT-1	GCCCCTGGTT	TCGGCATGGACGAGCTGTACAAGTAAACGC
CGATGTAGTGCAGTAG-1	GCCCGGCCAG	------------------------------
AGAGCTTCATCACAAC-1	GCCCTAAAGG	--GGCATGGACGAGCTGTACAAGTAAACGC
GTGCATACATGTTCCC-1	GCCCTCAGGA	------------------------------
AAACCTGTCAAAGTAG-1	GCCCTGACCA	TCGGCATGGACGAGCTGTACAAGTAAACGC
TCTTTCCTCTGGCGTG-1	GCCGATCGCA	------------------------------
GACAGAGGTAGTAGTA-1	GCCGCCTAGA	------------------------------
CTAAGACTCAGAGGTG-1	GCCGGTTTAT	TCGGCATGGACGAGCTGTACAAGTAAACGC
CCGTACTGTAAAGGAG-1	GCCGTAGGTC	TCGGCATGGACGAGCTGTACAAGTAAACGC
GACGTGCCATACCATG-1	GCCGTGCCTT	------------------------------
TGGCCAGCAGCCAGAA-1	GCCGTGCGAT	------------------------------
TGCTACCGTACCGGCT-1	GCCGTTGCAA	TCGGCATGGACGAGCTGTACAAGTAAACGC
CCTAGCTCAGCGATCC-1	GCCGTTGTGG	------------------------------
TCACGAAGTCTTTCAT-1	GCCGTTTGCC	TCGGCATGGACGAGCTGTACAAGTAAACGC
GACCTGGTCATGTCTT-1	GCCTACTGGC	TCGGCATGGACGAGCTGTACAAGTAAACGC
GACACGCCACGTGAGA-1	GCCTCAGGCG	------------------------------
GCGCGATGTTCATGGT-1	GCCTCGCAGG	TCGGCATGGACGAGCTGTACAAGTAAACGC
GAACCTAAGTCGAGTG-1	GCCTCTGTAT	GCGGAATGGACGAGCTGTACAAGTAAACGC
TCAGATGAGTGGGCTA-1	GCCTGAGCAG	TCGGCATGGACGAGCTGTACAAGTAAACGC
AGGTCATCAGACGCCT-1	GCCTGAGCCA	TCGGCATGGACGAGCTGTACAAGTAAACGC
GTTCGGGAGCCACGCT-1	GCCTGCTTCT	TCGGC-------------------------
TAAGCGTCACACATGT-1	GCCTGGCTCT	TCGGCATGGACGAGCTGTACAAGTAAACGC
GAGGTGACAAGTAGTA-1	GCCTGTTGTA	TCGGCATGGACGAGCTGTACAAGTAAACGC
ACGTCAACAGACGCTC-1	GCCTTAGATT	TCGGCATGGACGAGCTGTACAAGTAAACGC
AGGGATGTCACTGGGC-1	GCCTTTACGA	------------------------------
TCGCGTTGTCACCTAA-1	GCGAAATGAA	TCGGCATGGACGAGCTGTACAAGTAAACGC
CCTTCCCGTCCATCCT-1	GCGAATCCCG	TCGGCATGGACGAGCTGTACAAGTAAACGC
AAACGGGAGGTAAACT-1	GCGATCGTTA	------------------------------
AAAGATGGTGAAATCA-1	GCGCAAGTGC	------------------------------
ATGGGAGCACATCCAA-1	GCGCCCAGTT	TCGGCATGGACGAGCTGTACAAGTAAACGC
ATCTACTCATGGGACA-1	GCGCCGCATA	TCGGCATGGACGAGCTGTACAAGTAAACGC
TCGGGACAGAGGTAGA-1	GCGCCGTTGG	TCGGCATGGACGAGCTGTA-----------
CTCGTACAGATCCCGC-1	GCGCGCCGTT	TCGGCATGGACGAGCTGTACAAGTAAACGC
GGCCGATCACCTCGTT-1	GCGCTTCCTT	TCGGCATGGACGAGCTGTACAAGTAAACGC
TGGCTGGGTAGGACAC-1	GCGCTTGCCG	TCGGCATGGACGAGCTGTACAAGTAAACGC
TGTATTCTCACCATAG-1	GCGCTTTCAT	TCGGAATGGACGAGCTGTACAAGTAAACGC
TCTTTCCCACCACCAG-1	GCGGAAGCTT	------------------------------
TAAACCGCAGACAGGT-1	GCGGAGCGAT	TCGGCATGGACGAGCTGTACAAGTAAACGC
AGCGTCGCAGCTGGCT-1	GCGGGTCTCC	TCGGCATGGACGAGCTGTACAAGTAAACGC
GGAAAGCAGAACAATC-1	GCGTAAGGCA	------------------------------
ACACCGGAGGATGGTC-1	GCGTATAGAG	------------------------------
CGCTATCGTTACGGAG-1	GCGTATTAGC	TCGGCATGGACGAGCTGTACAAGTAAACGC
GCGGGTTGTAGAAGGA-1	GCGTCAGCTC	TCGGCATGGACGAGCTGTACAAGTAAACGC
ACGAGGAAGGCTACGA-1	GCGTCGAACT	TCGGCATGGACGAGCTGTACAAGTAAACGC
GATCGCGAGCTAGTGG-1	GCGTCGACGG	------------------------------
CGAGCACGTCCGAGTC-1	GCGTGGCGGT	TCGGCATGGACGAGCTGTACAAGTAAACGC
CCTACCATCCAAACTG-1	GCGTGGGCTC	TCGGCATGGACGAGCTGTACAAGTAAACGC
CTACACCCAGACGCAA-1	GCGTTCATTC	TCGGCATGGACGAGCTGTACAAGTAAACGC
GGGAGATAGATGGCGT-1	GCGTTGCGTA	TCGGCATGGACGAGCTGTACAAGTAAACGC
CTCGTACCACATCCGG-1	GCGTTGTCAT	------------------------AAACGC
CGCGGTAAGCTAGTTC-1	GCTAAATATG	TCGGCATGGACGAGCTGTACAAGTAAACGC
GGCAATTCAGCAGTTT-1	GCTAACGCCG	------------------------------
AACCATGCACCAACCG-1	GCTACACTTT	------------------------------
ACACCCTAGTACCGGA-1	GCTACAGTTT	TCGGCATGGACGAGCTGTACAAGTAAACGC
CTCGAGGGTCGCTTCT-1	GCTACGCCCC	TCGGCATGGACGAGCTGTACAAGTAAACGC
AGGCCACTCTAACCGA-1	GCTACTTTGT	------------------------------
ACGGAGAGTTATCACG-1	GCTAGCACTT	TCGGCATGGACGAGCTGTACAAGTAAACGC
CAGATCACACAGTCGC-1	GCTAGCATAA	TCGGCATGGACGAGCTGTACAAGTAAACGC
CATCCACTCCCTGACT-1	GCTATAGCAC	TCGGCATGGACGAGCTGTACAAGTAAACGC
TGACTTTTCAACACCA-1	GCTATCGTAC	TCGGCATGGACGAGCTGTACAAGTAAACGC
CTAGTGACAAATTGCC-1	GCTATCTGCA	TCGGCATGGACGAGCTGTACAAGTAAACGC
GCATGATGTGCGATAG-1	GCTATTAGTA	TCGGCATGGACGAGCTGTACAAGTAAACGC
GATTCAGTCATCTGCC-1	GCTATTTTCA	-------------------CAAGTAAACGC
ACACCCTAGTGTTTGC-1	GCTCACCGTT	------------------------------
ACATACGAGGCCCTCA-1	GCTCACGCCA	TCGGCATGGACGAGCTGTACAAGTAAACGC
TCAGGTAAGACTACAA-1	GCTCATGCAC	TCGGCATGGACTAGCTGTACAAGTAAACGC
CTCGGAGTCTGCCAGG-1	GCTCCATGAG	TCGGCATGGACGAGCTGTACAAGTAAACGC
GGAAAGCAGAACAATC-1	GCTCCATTTA	TCGGCATGGACGAGCTGTACAAGTAAACGC
CATATGGAGCTAAGAT-1	GCTCGAATGT	TCGACATGGACGAGCTGTACAAGTAAACGC
ACCAGTAGTATAGGGC-1	GCTCTCCGCT	TCGGCATGGACGAGCTGTACAAGTAAACGC
ATGCGATAGACAGGCT-1	GCTCTTGGAC	--GGCATGGACGAGCTGTACAAGTAAACGC
TAAGTGCCAAGCCCAC-1	GCTGAGTCAG	TCGGCATGGACGAGCTGTACACGTAAACGC
ACTTACTTCTTACCGC-1	GCTGATCAAG	------------------------------
AAACCTGTCAAAGTAG-1	GCTGCAAATC	TCGGCATGGACGAGCTGTACAAGTAAACGC
TGTGGTAGTCCAACTA-1	GCTGCGGGGC	TCGGCATGGACGAGCTGTACAAGTAAACGC
AGAGCGACAGATAATG-1	GCTGGCTCAC	TCGGCATGGACGAGCTGTACAAGTAAACGC
ACGATGTAGGAGCGTT-1	GCTGGTCATT	TCGGCATGGACGAGCTGTACAAGTAAACGC
TCGTAGAAGATGCCTT-1	GCTGGTGTGC	------------------------------
GGGCATCGTCGTGGCT-1	GCTGTATTAT	------------------------------
CGGTTAAGTGCGATAG-1	GCTGTCATTC	TCGGCATGGACGAGCTGTACAAGTAAACGC
GGCGACTTCCGAAGAG-1	GCTTACCAAG	TCGGCATGGACGAGCTGTACAAGTAAACGC
CCATGTCTCAACGGGA-1	GCTTATATGC	------------AGCTGTACAAGTAAACGC
CTGAAGTGTCAAACTC-1	GCTTATATTT	TCGGCATGGACGAGCTGTACAA--------
TTAACTCCATGAGCGA-1	GCTTATGTGG	TCGGCATGGACGAGCTGTACAAGTAAACGC
GCGCAACTCCTCTAGC-1	GCTTATTTGA	TCGGCATGGACGAGCTGTACAAGTAAACGC
AGCTTGAAGATATGGT-1	GCTTCAATTA	------------------------------
ACATCAGTCGTGGGAA-1	GCTTCATGGT	TCGGCATGGACGAGCTGTACAAGTAAACGC
CGAACATAGCTAACTC-1	GCTTCTGATG	------------------------------
TAAGCGTCATGCCTAA-1	GCTTGAGCTA	TCGGCATGGACGAGCTGTACAAGTAAACGC
ACCAGTAAGATCCTGT-1	GCTTGGTTAT	------------------------------
ATAACGCTCACGCGGT-1	GCTTGTCGGC	------------------------------
GCTCCTACACGCGAAA-1	GCTTGTGACA	TCGGCATGGACGAGCTGTACAAGTAAACGC
TACTCATAGCTGATAA-1	GCTTGTGCAA	TCGGCATGGACGAGCTGTACAAGTAAACGC
TGCCAAACAGGCTCAC-1	GCTTTATGTT	TCGGCATGGACGAGCTGTACAAGTAAACGC
CCCTCCTTCGTACCGG-1	GCTTTATTTT	------------------ACAAGTAAACGC
AGGTCATCACTATCTT-1	GCTTTCTTTC	TCGGCA------------------------
GGGAATGAGCGTTGCC-1	GCTTTGCCGA	------------------------------
AGTCTTTTCATGCATG-1	GCTTTGGTGG	TCGGCATGGACGAGCTGTACAAGTAAACGC
GATTCAGTCATCTGCC-1	GCTTTGTTGG	---------------TCGGCATGGACGAGC
AGCTTGAAGATATGGT-1	GCTTTGTTTT	TCGGCATGGACGAGCTGTACAAGTAAACGC
GGTGAAGGTCTCATCC-1	GCTTTTCGCG	TCGGCATGG---------------------
TACTTACCACTTAACG-1	GCTTTTGAAT	TCGGCATGGACGAGCTGTACAAGTAAACGC
TTGTAGGAGTACATGA-1	GCTTTTGGCC	TCGGCATG----------------------
AAAGTAGTCCCAAGTA-1	GGAAAATTTA	TCGGCATGGACGAGCTGTACAAGTAAACGC
GCGAGAAGTACTCTCC-1	GGAAATCCTT	------------------------------
TCAGCTCCAGTCACTA-1	GGAACATGGA	TCGGCATGGACGAGCTGTACAAGTAAACGC
GCAGTTAAGCCAGTTT-1	GGAAGTCCCT	TCGGCATGGACGAGCTGTACAAGTAAACGC
TACTTGTTCTATCCTA-1	GGAATACAGC	---GCATGGACGAGCTGTACAAGTAAACGC
CTTAACTCAAACCCAT-1	GGAATGTGAT	------------------------------
GGAAAGCGTAGGCTGA-1	GGAATTTGTT	TCGGCATGGACGAGCTGTACAAGTAAACGC
CTCGGGACATAAAGGT-1	GGACATTGAA	------------------------------
TAGTGGTCACGTGAGA-1	GGACCCGGAT	TCGGCATGGACGAGCTGTACAAGTAAACGC
CTGAAACCATATACCG-1	GGACCGTCAC	TCGGCATGGACGAGCTGTACAAGTAAACGC
CTAAGACTCAAAGTAG-1	GGACCTGGGA	-CGGCATGGACGAGCTGTACAAGTAAACGC
AAGGCAGCAACGATGG-1	GGACTACTGC	------------------------------
CGGACACGTGCTGTAT-1	GGACTATCAC	----------CGAGCTGTACAAGTAAACGC
ATTACTCGTGTGACCC-1	GGACTTTTAT	TCGGCATGGACGAGCTGTACAAGTAAACGC
CAGCAGCAGCTAGTGG-1	GGAGAAGTTT	--GGCATGGACGAGCTGTACAAGTAAACGC
GAGGTGACAGATGGCA-1	GGAGATTCTT	TCGGCATGGACGAGCTGTACAAGTAAACGC
GGCTGGTCACCACCAG-1	GGAGCGGGCA	TCGGCATGGACGAGCTGTACAAGTAAACGC
CTCACACAGTGTTGAA-1	GGAGCTCCAA	TCGGCATGGACGAGCTGTACAAGTAAACGC
CAGTCCTAGCTAACTC-1	GGAGGGGACT	TCGGCATGGACGAGCTGTACAAGTAAACGC
GAGCAGACATCGATTG-1	GGAGTTATAA	TCGGCATGGACGAGCTGTACAAGTAAACGC
GTACGTACAGCCTATA-1	GGAGTTTAAA	TCGGCATGGACGAGCTGTACAAGTAAACGC
GACGTTAGTGTCTGAT-1	GGATAACGGT	------------------------AAACGC
TTTACTGCAACTGCTA-1	GGATAGGCGT	TCGGCATGGACGAGCTGTACAAGTAAACGC
TTGCGTCAGAGATGAG-1	GGATCGCTTA	TCGGCATGGACGAGCTGTACAAGTAAACGC
TGAAAGAGTAGTAGTA-1	GGATGCCAGC	------------------------------
CTAAGACCATGGATGG-1	GGATGGCAGA	TCGGCATGGACGAGCTGTACAAGTAAACGC
CATCAAGCAAAGCAAT-1	GGATGGGGCA	TCGGCATGGACGAGCTGCACAAGTAAACGC
CCCAATCTCCGTCAAA-1	GGATGTAATC	TCGGCATGGACGAGCT--------------
TCTCTAACAAGTTCTG-1	GGATTACCGC	TCGGCATGGACGAGCTGTACAAGTAAACGC
TCTCTAAGTTTAGGAA-1	GGATTTCCCT	TCGGCATGGACGAGCTGTACAAGTAAACGC
CACACTCGTACTTCTT-1	GGATTTCGGT	TCGGCATGGACGAGCTGTACAAGTAAACGC
CTCTACGGTTCCACAA-1	GGATTTGAAT	TCGGCATGGACGAGCTGTACAAGTAAACGC
CATATTCGTTCGTTGA-1	GGCAAACAGT	TCGGCATGGACGAGCTGTACAAGTAAACGC
GTACGTAAGATGTGGC-1	GGCAACTCTT	TCGGCATGGACGAGCTGTACAAGTAAACGC
CCGGTAGAGCATCATC-1	GGCACAATTA	TCGGCATGGACGAGCTGTACAAGTAAACGC
GCATGTATCGCGGATC-1	GGCAGGTAGT	------------------------------
GACAGAGCACGGCCAT-1	GGCATGTACC	TCGGCATGGACGAGCTGTACAAGTAAACGC
CTGCCTACAGTTAACC-1	GGCCAGTAGA	TCGGCATGGACGAGCTGTACGAGTAAACGC
ATTTCTGGTCTTGTCC-1	GGCCAGTTTT	------------------------------
TCAGCTCCAATAGAGT-1	GGCCATTTGG	-------------------CAAGTAAACGC
CGACCTTGTACCTACA-1	GGCCCGGGGT	TCGGCATGGACGAGCTGTACAAGTAAACGC
ACGGAGATCTCAAACG-1	GGCCGAAAAG	--------------CTGTACAAGTAAACGC
CGATCGGTCAATACCG-1	GGCCGTCTCC	TCGGCATGGACGAGCTGTACAAGTAAACGC
TGACTTTCATCTACGA-1	GGCCTAAGAC	TCGGCATGGACGAGCTGTACAAGTAAACGC
AACCATGGTATTCGTG-1	GGCCTAGATT	TCGGCATGGACGAGCTGTACAAGTAAACGC
CAGCAGCTCTTGAGAC-1	GGCCTATATA	TCGGCATGGACGAGCT--------------
ACGGGCTGTTCTGTTT-1	GGCCTCGATT	TCGGCATGGACGAGCTGTACAAGTAAACGC
AGAGCGAGTCCAGTGC-1	GGCCTGAGGA	TCGGCATGGACGAGCTGTACAAGTAAACGC
ACGATGTTCCTTTACA-1	GGCCTTTCCT	TCGGCATGGACGAGCTGTACAAGTAAACGC
TCGAGGCTCCCAAGAT-1	GGCGAGGGCC	TCGGTATGGACGAGCTGTACAAGTAAACGC
CAGAGAGGTATATGGA-1	GGCGCCCTGG	TCGGCATGGACGAGCTGTACAAGTAAACGC
TGATTTCAGAGATGAG-1	GGCGCTGTAC	TCGGCATGGACGAGCTGTACAAGTAAACGC
CCGGGATTCTTGTCAT-1	GGCGGAAGCG	------------------------------
AGCGGTCGTAGATTAG-1	GGCGTGCGGT	------------------------------
ACGCCAGGTCGAATCT-1	GGCGTGGTTG	------------------------------
AGAGTGGAGGAGCGAG-1	GGCTACCTCA	TCGGCATGGACGAGCTGTACAAGTAAACGC
GTCTCGTTCCCAAGTA-1	GGCTCAATCA	-----------GAGCTGTACAAGTAAACGC
GAATAAGTCAGAGACG-1	GGCTCCTGTT	TCGGCATGGACGAGCTGTACAAGTAAACGC
GTCAAGTGTAAGGATT-1	GGCTGCCGTC	TCGGCATGGACGAGCTGTACAAGTAAACGC
GGACATTAGCCCGAAA-1	GGCTGGACCA	TCGGCATGGACGAGCTGTACAAGTAAACGC
TACTTGTTCTATCCTA-1	GGCTGGTATT	------------------------------
CTCGAGGAGCGCCTTG-1	GGCTTACCGC	TCGGCATGGACGAGCTGTACAAGTAAACGC
TCATTTGGTTCGAATC-1	GGCTTCCCAG	TCGGCATGGACGAGCTGTACAAGTAAACGC
CAGCAGCAGCTAGTGG-1	GGCTTCCCGT	TCGGCATG----------------------
GTTACAGAGTTGAGTA-1	GGGAATATTT	----------CGAGCTGTACAAGTAAACGC
CCGTACTGTAAAGGAG-1	GGGAATTGGT	------------------------------
CTGAAGTTCACATGCA-1	GGGACATACT	-----------GAGCTGTACAAGTAAACGC
ACGGAGATCTCATTCA-1	GGGACGACGT	TCGGCATGGACGAGCTGTACAAGTAAACGC
CCTTACGAGCAGCCTC-1	GGGACGCCGC	TCGGCATGGACGAGCTGTACAAGTAAACGC
ACAGCTAAGGAGCGAG-1	GGGCAATACT	TCGGCATGGACGAGCTGTACAAGTAAAAGC
AATCCAGAGTTTCCTT-1	GGGCAATTGT	ACGGCATGGACGAGCTGTACAAGTAAACGC
ATCCGAAGTGTTTGGT-1	GGGCCTATGG	TCGGCATGGACGAGCTGTACAAGTAAACGC
GCGCGATGTAGCTAAA-1	GGGCTTAGCA	------------------------------
CTGAAACGTTTGACTG-1	GGGGAGGGCC	-------------GCTGTACAAGTAAACGC
CGTTAGAAGCTGCAAG-1	GGGGCTAATT	TCGGCATGGACGAGCTGTACAAGTAAACGC
TTCTTAGGTACGAAAT-1	GGGGTATTCG	TCGGCATGGACGAGCTGTACAAGTAAACGC
AGTAGTCGTGTGCCTG-1	GGGGTGCAGG	TCGGCATGGACGAGCTGTACAAGTAAACGC
CACATTTGTAAGGATT-1	GGGTCTGACC	TCGGCATGGACGAGCTGTACAAGTAAACGC
AACACGTAGACTCGGA-1	GGGTTCAACC	----CATGGACGAGCTGTACAAGTAAACGC
GTCTTCGCACGTCTCT-1	GGGTTCTGGT	TCGCCATGGACGAGCTGTACAAGTAAACGC
TAAGCGTGTTTCGCTC-1	GGGTTCTGTC	------------------------------
CTTCTCTGTAAGGGCT-1	GGTAAAAAGC	TCGGCATGGACGAGCTGTACAAGTAAACGC
AGCTCCTGTAAAGTCA-1	GGTAATATTG	------------------------------
ATCCGAAGTGTTTGGT-1	GGTAATGTTA	TCGGCATGGACGAGCTGTACAAGTAAACGC
GTGTGCGCATTGAGCT-1	GGTATAAGGA	------------------------------
CTACATTTCACATAGC-1	GGTATATTAC	TCGGCATGGACGAGCTGTACAAG-------
TTATGCTGTTGAACTC-1	GGTATGCTAC	------------------------------
AGTGAGGCATGTTGAC-1	GGTCAATTCC	------------------------------
TTCGAAGCAGTCAGCC-1	GGTCAGCCTT	TCGGCATGGACGAGCTGTACAAGTAAAC--
TGTTCCGCAAAGTCAA-1	GGTCAGGTTC	TCGGCATGGACGAGCTGTACAAGTAA----
GCGAGAAGTACTCTCC-1	GGTCCAAGTA	TCGGCATGGACGAGCTGTACAAGTAAACGC
GCTGCGAGTCTCTTAT-1	GGTCCGTATT	TCGGCATGGACGAGCTGTACAAGTAAACGC
AGTAGTCGTTATCACG-1	GGTCGGCAAT	TCGGCATGGACGAGCTGTACAAGTAAACGC
GGGCACTAGCGTCTAT-1	GGTCTCCTGT	TCGGCATGGACGAGCTGTACAAGTAAACGC
CAAGTTGCACCGAAAG-1	GGTCTGCACT	TCGGCATGGACGAGCTGTACAAGTAAACGC
CATATGGGTGTGGCTC-1	GGTCTTCGAA	TCGGCATGGACGAGCTGTACAAGTAAACGC
GTAACTGTCGGTGTTA-1	GGTCTTCTGT	------------------------------
CAGTAACCAGGCAGTA-1	GGTCTTGAGC	------------------------------
CTGTGCTGTTCGTGAT-1	GGTGAAGATT	TCGGCATGGACGAGCTGTACAAGTAAACGC
TAGTGGTCACGTGAGA-1	GGTGCCTGCT	TCGGCATGGACGAGCTGTACAAGTAAACGC
CGGCTAGCAGGAATCG-1	GGTGGCTGGT	TCGGCATGGACGAGCTGTACAAGTAAACGC
ACGATGTGTCTCCCTA-1	GGTGGTAAAA	------------------------------
TGGCCAGTCGTAGGTT-1	GGTGTGTTCG	TCGGCAAGGACGAGCTGTACAAGTAAACGC
TGAAAGAAGGAATTAC-1	GGTGTTAACG	TCGGCATGGACGAGCTGTACAAGTAAACGC
ACGATGTAGTCCTCCT-1	GGTTCAAGTA	TCGGCATGGACGAGCTGTACAAG-------
CTGAAGTAGCGAGAAA-1	GGTTCCACAA	TCGGCATGGA--------------------
ATTACTCAGAGGTAGA-1	GGTTCTCTTG	TCGGCATGGACGAGCTGTACAAGTAAACGC
TCTCTAAGTCGGATCC-1	GGTTGCATCC	TCGGCATGGACGAGCTGTACAAGTAAACGC
CCGGGATTCCTAGGGC-1	GGTTGTCACT	TCGGCATGGACGAGCTGTACAAGTAAACGC
GGGCATCCATATGGTC-1	GGTTGTCGCA	TCGGCATGGACGAGCTGTACAAGTAAACGC
AACCATGAGTGAAGTT-1	GGTTGTGAGT	TCGGCATGGACGA-----------------
TCTCATAGTGAAGGCT-1	GGTTTAAGTT	TCGGCATGGTCGAGCTGTACAAGTAAACGC
TAGTTGGGTGAGTATA-1	GGTTTCCCCA	TCGGCATGGACGAGCTGTACAAGTAAACGC
GAGCAGAGTATGGTTC-1	GGTTTGCTAA	TCGGCATGGACGAGCTGTACAAGTAAACGC
CACATAGTCGTTACAG-1	GGTTTGTTTG	TCGGCATGGACGAGCTGTACAAGTAAACGC
AGCTCTCAGAACTCGG-1	GGTTTTGGTT	-------------------------AACGC
CGAGCCACACATTAGC-1	GGTTTTTAAT	TCGGCATGGACGAGCTGTACA---------
GTACTCCGTATCAGTC-1	GTAAACCTCT	TCGGCATGGACGAGCTGTACAAGTAAACGC
GAATAAGAGATGCCAG-1	GTAAACTAGC	------------------------------
CGTCCATTCAGCTCGG-1	GTAAATATAG	------------------------------
CCTAGCTCAGCGATCC-1	GTAAGACAGG	TCGGCATGGACGAGCTGTACAAGTAAACGC
ACGATACTCTAACTTC-1	GTAAGGACTG	TCGGCATGGACGAGCTGTACAAGTAAACGC
TGCCAAACAGGCTCAC-1	GTAAGGTAAC	-------GGACGAGCTGTACAAGTAAACGC
ACGCCGATCTATCGCC-1	GTAAGTGATT	TCGGCATGGACGAGCTGTACAAGTAAACGC
TGTCCCAGTCTTGTCC-1	GTAAGTTATG	------------------------------
GGTATTGCACCCATTC-1	GTAATAGACG	TCGGCATGGACGAGCTGTACAAGTAAACGC
AGTGTCACAATCACAC-1	GTAATGGTCG	------------------------------
AGCTCCTGTGACAAAT-1	GTACAACCCC	TCGGCATGGACGAGCTGTACAAGTAAACGC
AGGCCACTCTAACCGA-1	GTACCAACCT	TCGGCATGGACGAGCTGTACAAGTA-----
GGTGTTAGTCAGAGGT-1	GTACCAGACT	TCGGCATGGACGAGCTGTACAAGTAAACGC
GAAACTCTCACATAGC-1	GTACCATCCC	TCGGCATGGACGAGCTGTACAAGTAAACGC
GTGTGCGGTAGCGCTC-1	GTACCCAATT	--GGCATGGACGAGCTGTACAAGTAAACGC
TTAACTCGTTAAGTAG-1	GTACCCCAAA	------------------------------
AAACGGGCATGTTCCC-1	GTACCCTTTT	---GCATGGACGAGCTGTACAAGTAAACGC
CTGAAACTCTTTACGT-1	GTACGAACTG	TCGGCATGGACGAGCTGTACAAGTAAACGC
CTACCCACAGGTCTCG-1	GTACTCACTA	TCGGCATGGACGAGCTGTACAAGTAAACGC
CACATAGTCGTTACAG-1	GTACTCAGGC	TCGGCATGGACG------------------
TGGCTGGCATACAGCT-1	GTAGACAAAG	TCGGCATGGACGAGCTGTACAAGTAAACGC
AGGGAGTAGTAACCCT-1	GTAGACGCTT	TCGGCATGGACGAGCTGTACAAGTAAA---
CTGCGGAGTAGAGTGC-1	GTAGAGTCCA	---GCATGGACGAGCTGTACAAGTAAACGC
CAGCATAGTGAAGGCT-1	GTAGCATCGT	TCGGCATGAACGAGCTGTACAAGTAAACGC
TAAGCGTGTAGGGACT-1	GTAGCCGTGA	TCGGCATGGACGAGCTGCACAAGTAAACGC
CATCGGGCAGGGTACA-1	GTAGCTTGAA	TCGGCATGGACGAGCTGTACAAGTAAACGC
GCACTCTGTACCGGCT-1	GTAGTAATTA	TCGGCATGGACGAGCTGTACAAGTAAACGC
CCACCTACATCTCCCA-1	GTAGTCGTAT	------------------------------
CTGCCTACAGTTAACC-1	GTAGTTCGCT	TCGGCATGGACGAGCTGTACAAGTAAACGC
GTAACTGCAAGTAATG-1	GTATAATTTG	TCGGCATGGACGAGCTGTACAAGTAAACGC
GACACGCTCAGCTTAG-1	GTATATAGGG	----------------------GTAAACGC
TCTCTAAAGGCCGAAT-1	GTATATAGTT	TCGGCA------------------------
AACACGTAGACTCGGA-1	GTATCATATA	----------CGAGCTGTACAAGTAAACGC
CACCTTGTCAGAAATG-1	GTATCTAATT	TCGGCATGGACGAGCTGTACAAGTAAACGC
AGCCTAAAGCCAACAG-1	GTATCTTTTG	TCGGCATGGACGAGCTGTACAAGTAAACGC
AACTGGTCACGTGAGA-1	GTATGCAGAA	TCGGCATGGACGAGCTGTACAAGTAAACGC
CATTCGCTCGATAGAA-1	GTATGCCATT	TCGGCATGGACGAGCTGTACAAGTAAACGC
CCGGTAGGTGTGACCC-1	GTATGCTTCA	TCGGCATGGACGAGCTGTACAAGTAAACGC
ACTTGTTAGCAGATCG-1	GTATTATTCC	TCGGCATGGACGAGCTGTACAAGTAAAAGC
ATCGAGTAGTAGATGT-1	GTATTGTTCT	TCGGCATGGACGAGCTGTACAAGTAAACGC
TGTATTCCACACAGAG-1	GTATTTGCGA	TCGGCATGGACGAGCTGTACAAGTAAACGC
CTAGTGACAACGATGG-1	GTATTTTTTT	TCGGCATGGACGAGCTGTACAAGTAAACGC
ACGGGCTCAGGGTATG-1	GTCAACGTTG	TCGGCATGGACGAGCTGTACAAGTAAACGC
CGGTTAAGTGCGATAG-1	GTCAAGGATC	------------------------------
ACTGAACTCCAAATGC-1	GTCAATGGTG	TCGGCATGGACGAGCTGTACAAGTAAACGC
TCTTTCCGTTCAGTAC-1	GTCACATGGG	TCGGCATGGACGAGCTGTACAAGTAAACGC
AACTTTCGTAAGGGAA-1	GTCACCGAGT	TCGGCATGGACGAGCTGTACAAGTAAACGC
TTGGAACCATGCTAGT-1	GTCACTCCTT	------------------------------
ACGCCAGTCCAAACAC-1	GTCACTCTTT	TCGGCATGGACGAGCTGTACAAGTAAACGC
GGGTTGCCAGTGACAG-1	GTCAGGCCCG	TCGGCATGGACGAGCTGTACAAGTAAACGC
AGGCCGTAGAGCTATA-1	GTCAGTGACG	-------GGACGAGCTGTACAAGTAAACGC
GATCGCGAGAGCTGCA-1	GTCATGACGG	TCGGCATGGACGAGCTGTACAAGTAAACGC
ATAAGAGGTTGGTAAA-1	GTCATGCTCT	TCGGCATGGACGAGCTGTACAAGTAAACGC
CACCACTTCAAAGACA-1	GTCATGGGTT	------------------------------
AGTTGGTGTGAACCTT-1	GTCATGTAGC	------------------------------
ATAACGCTCACGCGGT-1	GTCATGTTAA	------------AGCTGTACAAGTAAACGC
CTCCTAGAGGGCTTGA-1	GTCATTCCAG	------------------------------
GTCCTCACATGTCGAT-1	GTCATTCCTG	TCGGCATGGACGAGCTGTACAAGTAAACGC
AATCGGTCATCCGGGT-1	GTCATTCTAG	------------------------------
AGCTTGACAGAAGCAC-1	GTCCAAGCTG	TCGGCATGGACGAGCTGTACAAGTAAACGC
CGAACATAGAAACGAG-1	GTCCAATTTT	TCGGCATGGACGAGCTGTACAAGTAAACGC
TTGGCAAAGGAGTCTG-1	GTCCCATCGC	TCGGCATGGACGAGCTGTACAAGTAAACGC
GATGCTAAGAATAGGG-1	GTCCCCCGGT	------------------------------
TACCTTACATCCTAGA-1	GTCCCCGTTT	TCGGCATGGACGAGCTGTACAAGTAAACGC
TTCTCAACAAAGAATC-1	GTCCGGTTAA	TCGGCATGGACGAG----------------
TGCACCTCACACCGAC-1	GTCCGTGCTA	------------------------------
CACACAAAGTCGATAA-1	GTCCTCCGAT	TCGGCATGGACGAGCTGTACAAGTAAACGC
CCCAGTTGTCAGAAGC-1	GTCCTCTCTT	TCGGCATGGACGAGCTGTACAAGTAAACGC
CAGCATAAGAGCTGGT-1	GTCCTTCTGT	TCGGCATGGACGAGCTGTACAAGTAAACGC
GTCTCGTCAAGAGTCG-1	GTCGATCTGT	TCGGCATGGACGAGCTGTACAAGTAAACGC
GTACTCCGTATCAGTC-1	GTCGCACCTG	------------------------------
TACTTGTTCTATCCTA-1	GTCGCCACGG	TCGGCATGGACGAGCTGTACAAGTAAACGC
TTAACTCGTTAAGTAG-1	GTCGGAAAAT	TCGGCATGGACGAGCTGTACAAGTAAACGC
CTAATGGAGTGCAAGC-1	GTCGGGCAAA	------------------------------
GCTTCCAGTGTGAAAT-1	GTCGGTGGGA	TCGGCATGGACGAGCTGTACAAGTAAACGC
GCGCGATCACAGAGGT-1	GTCGGTTCGA	------------------------------
TCGGGACCATGGTAGG-1	GTCGTATAGG	TCGGCATGGACGAGCTGTACAAGTAAACGC
GTAGGCCCAATGGACG-1	GTCGTGTACC	TCGGCATGGACGAGCTGTACAAGTAAACGC
CGTCACTAGCAGACTG-1	GTCGTGTAGT	-------GGACGAGCTGTACAAGTAAACGC
AGGCCACAGTCATGCT-1	GTCTAATCTA	------------------------------
TGAGAGGTCTGCAAGT-1	GTCTAGGATC	------------------------------
TCTTTCCTCCAGAGGA-1	GTCTCAGTCT	TCGGCATGGACGAGCTGTACAAGTAAACGC
TACAGTGCATCAGTAC-1	GTCTCCGCCC	TCGACATGGACGAGCTGTACAAGTAAACGC
CTCGTACAGGCAATTA-1	GTCTCCTCGG	TCGGCATGGACGAGCTGTACAAGTAAACGC
TGCGCAGAGCGTTTAC-1	GTCTCCTTTA	TCGGCATGGACGAGCTGTACAAGTAAACGC
CACACAATCTTGCATT-1	GTCTCGAAGT	------------------------------
CTACATTCAATAGCAA-1	GTCTGGGTTT	------------------------AAACGC
GGGTTGCTCTGTTGAG-1	GTCTGTCAAG	TCGGCATGGACGAGCTGTACAAGTAAACGC
GAGTCCGGTGCTGTAT-1	GTCTGTCTGG	TCGGCATGGAC-------------------
CACATAGTCGTTACAG-1	GTCTTCCGTA	--------GACGAGCTGTACAAGTAAACGC
GCAGTTATCCCAGGTG-1	GTCTTGCCAA	TCGGCATGGACGAGCTGTACAAGTAAACGC
GTAGTCACATCCGCGA-1	GTCTTGCTTA	--------GACGAGCTGTACAAGTAAACGC
AGGTCATCACTCAGGC-1	GTCTTTTTCC	TCGGCATGGACGAGCTGTACAAGTAAACGC
GGGAGATTCAAGCCTA-1	GTGAAGGGTT	TCGGCATGGACGAGCTGTACAAGTAAACGC
TACCTATCAGGGAGAG-1	GTGAATCTCA	------------------------------
AACCGCGAGTGTCCAT-1	GTGAATTACT	------------------------------
GTCTCGTTCCCAAGTA-1	GTGACAGTAG	------------------------------
CGCTGGAGTAAATGTG-1	GTGACCTCGG	------------------------------
AACGTTGAGACAATAC-1	GTGACTGATC	TCGGCATGGACGAGCTGTACAAGTAA----
ATAACGCTCAATAAGG-1	GTGATAATAC	TCGGCATGGACGAGCTGTACAAGTAAACGC
TAAGCGTAGTCAAGCG-1	GTGATTACAT	------------------------------
CACAGTACATCTGGTA-1	GTGATTCGTT	------------------------------
AGCGGTCGTTTGACTG-1	GTGATTTCCA	TCGGCATGGACGAGCTGTACAAGTAAACGC
CCGTGGATCATCATTC-1	GTGCAATTAT	------------------------------
CCGGTAGAGAGCCCAA-1	GTGCGAAACC	TCGGCATGGACGAGCTGTACAA--------
AAAGATGTCGATGAGG-1	GTGCTATTAA	TCGGCATGGACGAGCTGTACAAGTAAACGC
GGACAAGTCATACGGT-1	GTGCTGAGGC	TCGGCATGGACGAGCTGTACAAGTAAACGC
CCGGTAGAGCATCATC-1	GTGGACCCGC	------------------------------
ACTGAGTCATCGACGC-1	GTGGAGCAGG	TCGGCATGGACGAGCTGTACAAGTAAACGC
TGCGTGGGTGGTTTCA-1	GTGGCCCGGG	TCGGCATGGACGAGCTGTACAAGTAAACGC
ACACTGATCTCGTTTA-1	GTGGGCTATT	-------GGACGAGCTGTACAAGTAAACGC
CGATGTAGTGCAGTAG-1	GTGGGTCTAT	TCGGCATGGACGAGCTGTACAAGTAAACGC
TCTCATAGTATGAAAC-1	GTGGGTGCTG	TCGGCATGGACGAGCTGTACAAGTAAACGC
GTACTTTCATCCTAGA-1	GTGGGTGGCT	TCGGCATGGACGAGCTGTACAAGTAAACGC
ACAGCTACATGGTCTA-1	GTGGGTTCGC	TCGGCATGGACGAGCTGTACAA--------
TGCCAAACAGGCTCAC-1	GTGTAAGTTT	------------AGCTGTACAAGTAAACGC
CGTCTACAGCTGCCCA-1	GTGTACGTTG	TCGGCATGGACGAGCTGTACAAGTAAACGC
GCTTGAATCATCATTC-1	GTGTACTAAT	TCGGCATGGACGAGCTGTACAAGTAAACGC
ACGGGCTTCAAAGACA-1	GTGTATTTAG	------------------------------
TGCCCATTCCACGTTC-1	GTGTCATATT	------------------------------
TCAGCTCCATGGGACA-1	GTGTCGGCGC	------------------------------
TGCCCATAGTGGCACA-1	GTGTCTCTAC	TCGGCATGGACGAGCTGTACAAGTAAACGC
CTGTTTAGTCCTCTTG-1	GTGTGCGATT	TCGGCATGGACGAGCTGTACAAGTAAACGC
CTTCTCTGTCGTTGTA-1	GTGTGCTAGT	-------GGACGAGCTGTACAAGTAAACGC
AACCATGGTAGAAAGG-1	GTGTGGCACC	TCGGCATGGACGAGCTGTACAAGTAAACGC
ACACCCTAGCGCCTCA-1	GTGTGTCGCC	------------------------------
CGTCACTAGAAGGTGA-1	GTGTGTTAGT	TCGGCATGGACGAGCTGTACAAGTAAACGC
TGTCCCAAGCCGCCTA-1	GTGTTGCACG	------------------------------
CGATGGCAGAGGACGG-1	GTGTTTCATT	TCGGCATGGACGAGCTGTACAAGTAAACGC
AGTTGGTGTGAACCTT-1	GTTAAACATA	TCGGCATGGACGAGCTGTACAAGTAAACGC
GGCCGATAGTCCATAC-1	GTTAACATGT	TCGGCATGGACGAGCTGTACAAGTAAACGC
ACGGGCTTCAAAGACA-1	GTTAAGCCGG	TCGGCATGGACGAGCTGTACAAGTAAAC--
GCACTCTTCTCAAACG-1	GTTAAGTATT	------------------------------
GTGTTAGCAGTAAGAT-1	GTTAATGGTT	------------------------------
TGACTAGCATCGGTTA-1	GTTACAGGGT	------------------------------
CCTAGCTCAGCCTGTG-1	GTTACGATTA	--------GACGAGCTGTACAAGTAAACGC
TGAGAGGAGGTGACCA-1	GTTACTCATT	TCGGCATGGACGAGCTGTACAAGTAAACGC
AAGGCAGAGCCCGAAA-1	GTTAGAACGT	-------------------CAAGTAAACGC
TAGAGCTAGTTTGCGT-1	GTTAGCTTTC	TCGGCATGGACGAGCTGTACAAGTAAACGC
TTGGAACCAGGACCCT-1	GTTAGTTAAG	------------------------------
CTCGTACAGAACAATC-1	GTTATATGGA	TCGGCATGGACGAGCTGTACAAGTAAACGC
TACACGAGTTCGGGCT-1	GTTATATTGC	TCGGCATGGACGAGCTGTACAAGTAAACGC
TACGGGCTCGTTACAG-1	GTTATATTTT	TCGGCATGGACGAGCTGTACAAGTAAACGC
TTAGTTCCAGCCTGTG-1	GTTATGCCAT	------------------------------
TGTTCCGAGATATGGT-1	GTTATGGCCC	------------------------------
TTGTAGGAGTGGCACA-1	GTTATTATCT	------------------------------
AGAATAGGTCTGATTG-1	GTTATTCTCA	TCGGCATGGACGAGCTGTACAAGTAAACGC
ACACCGGGTGTCAATC-1	GTTCATTTTT	-----------------TACAAGTAAACGC
GTCATTTCATCCTAGA-1	GTTCCATTAT	TCGGCATGGACGAGCTGTACAAGTAAACGC
GGACAAGGTGAGGGAG-1	GTTCCGCCAG	----------------GTACAAGTAAACGC
TGGCGCAAGAATTCCC-1	GTTCCGCTAC	TCGGCATGGACGAGCTGTACAAGTAAACGC
CAGCTGGGTGCCTGTG-1	GTTCCGGCTA	TCGGCATGGACGAGCTGTACAAGTAAACGC
CTTAACTCATCTCCCA-1	GTTCCTCATA	TCGGCATGGACGAGCTGTACAAGTAAACGC
TGCGGGTGTGGAAAGA-1	GTTCGACAAA	TCGGCATGGACGAGCTGTACAAGTAAACGC
CTCATTAAGTGGACGT-1	GTTCGGCAGA	TCGGCATGGACGAGCTGTACAAGTAAACGC
TTCTCCTAGGCGTACA-1	GTTCGTTTAG	TCGGCATGGACGAGCTGTACAAGTAAACGC
TGATTTCAGAGATGAG-1	GTTCTACAAC	TCGGCATGGACGAGCTGTACAAGTAAACGC
CAACCAAGTCGAACAG-1	GTTCTATTCG	---GCATGGACGAGCTGTACAAGTAAACGC
TGCCCTATCTGCGTAA-1	GTTCTCTGTG	TCGGCATGGACGAGCTGTACAAGTAAACGC
GACGCGTGTCTAGCCG-1	GTTCTGGGTA	TCGGCATGGACGAGCTGTACAAGTAAACGC
AGTGAGGCAACACCTA-1	GTTCTTATTA	TCGGCATGGACGAGCTGTACAAGTAAACGC
GGCGACTGTAGCGCTC-1	GTTCTTTACA	TCGGCATGGACGAGCTGTACAAGTAAACGC
CAAGATCCAGCGTCCA-1	GTTCTTTCCA	TCGGCATGGACGAGCTGTACAAGTAAACGC
GTTCTCGAGATGGCGT-1	GTTCTTTGGT	------------AGCTGTACAAGTAAACGC
CGATTGACATCGATTG-1	GTTGAACTCC	TCGGCATGGACGAGCTGTACAAGTAAACGC
CATCAAGCACAAGTAA-1	GTTGACGCCA	TCGGCATGGACGAGCTGTACAAGTAAACGC
CGCGGTACATGAAGTA-1	GTTGCAATTT	TCGGCATGGACGAGCTGTACAAGTAAACGC
GTCTCGTAGCGTCTAT-1	GTTGCACACG	TCGGCATGGACGAGCTGTACAAGTAAACGC
CTCAGAAAGCCACTAT-1	GTTGGAGGAT	TCGGCATGGACGAGCTGTACAAGTAAACGC
CTACCCAGTCTAAACC-1	GTTGGCTTTT	TCGGCATGGACGAGCTGTACAAGTAAACGC
ACTGCTCCAATAGCGG-1	GTTGGGGTTC	TCGGCATGGACGAGCTGTACAAGTAAACGC
AGAATAGGTCTGATTG-1	GTTGGGTGTT	TCGGCATGGACGAGCTG-------------
CCGGTAGAGCATCATC-1	GTTGGTATTG	TCGGCATGGACGAGCTGTACAAGTAAACGC
AGCCTAAAGTCCAGGA-1	GTTGTAACGT	------------------------------
ACGGAGACAAGTAATG-1	GTTGTACGAA	TCGC--------------------------
CTAAGACCACTTCGAA-1	GTTGTCCGTG	TCGGCATGGACGAGCTGTACAAGTAAACGC
CACAGTAGTTAGGGTG-1	GTTGTCGTGA	TCGGCATGGACGAGCTGTACAAGTAAACGC
TGGTTCCCACCAGTTA-1	GTTGTCTAGA	------------------------------
TCTATTGCAGGGTTAG-1	GTTGTGATAG	------------------------------
TAAGCGTGTAGGGACT-1	GTTGTTTTGT	TCGGCATGGACGAGCTGTACAAGTAAACGC
TGTATTCGTATATGAG-1	GTTTAATCGT	TCGGCATGGACGAGCTGTACAAGTAAACGC
TGGACGCGTTCCCGAG-1	GTTTAGTCTT	TCGGCATGGACGAGCTGTACAAGTAAACGC
GGAGCAACATATACCG-1	GTTTATTTTC	---------------------AGTAAACGC
GCAAACTTCAGCATGT-1	GTTTCCAATT	TCGGCATGGACGAGCTGTACAAGTAAACGC
CTCGGGAAGACCGGAT-1	GTTTCTTAAC	TCGGCATGGACGAGCTGTACAAGTAAACGC
CGGACGTGTGTGTGCC-1	GTTTGAAGTT	TCGGCATGGACGAGCTGTACAAGTAA----
GACACGCCACGTGAGA-1	GTTTGATTCG	------------------------------
CACCTTGTCGCTTAGA-1	GTTTGCCGAA	------------------------------
GAGGTGAGTACATCCA-1	GTTTGCGGTC	TCGGCATGGACGAGCTGTACAAGTAAACGC
TGGCCAGAGTGGAGTC-1	GTTTGCTTTT	----------------GTACAAGTAAACGC
TTTGCGCCACCAGGCT-1	GTTTGTATAC	TCGGCATGGACGAGCTGTACAAGTAAACGC
CCTATTATCTGCTGTC-1	GTTTGTGCCA	------------------------------
GGACGTCTCACCGGGT-1	GTTTGTGTAA	TCGGCATGGACGAGCTGTACAAGTAAACGC
CACATTTCAAGGGTCA-1	GTTTGTGTAG	TCGGCATGGACGAGCTGTACAAGTAAACGC
CGTCAGGGTCTCCCTA-1	GTTTTAATGT	TCGGCATGGACGAGCTGTACAAGTAAACGC
CGTGTAATCCTAGAAC-1	GTTTTATAAA	TCGGCATGGACGAGCTGTACAAGTAAACGC
CGCTATCTCAACCAAC-1	GTTTTCAGGG	TCGGCATGGACGAGCTGTACAAGTAAACGC
ACTTACTCATACTACG-1	GTTTTCTTGT	TCGGCATGGACGAGCTGTACAAGTAAACGC
CACATTTCAAGGGTCA-1	GTTTTGGAAC	TCGGCATGGACGAGCTGTACAAGTAAACGC
ATCGAGTGTTTAGCTG-1	GTTTTTAATG	TCGGCATGGACGAGCTGTACAAGTAAACGC
TTAGGACCAAGTACCT-1	GTTTTTTAAT	TCGGCATGGACGAGCTGTACAAGTAAACGC
CTAGTGAGTCTTTCAT-1	TAAAAAGGTT	TCGGCATGGACGAGCTGTACAAGTAAACGC
CGATGTAAGTAGATGT-1	TAAAACTGTA	TCGGCATGGACGAGCTGTACAAGTAAACGC
AAATGCCTCGCAGGCT-1	TAAAATGTTC	-------GGACGAGCTGTACAAGTAAACGC
GCGAGAAAGCCAGTTT-1	TAAAATTTCT	------------------------------
GTACTCCGTACACCGC-1	TAAACACTAA	------------------------------
TGCCAAAGTAAACGCG-1	TAAACTTTTT	TCGGCATGGACGAGCTGTACAAGTAAACGC
CGTCCATAGGTGATAT-1	TAAAGCTCTG	TCGGCATGGACGAGCTGTACAAGTAAACGC
GTACGTACAGCCTATA-1	TAAATGTATG	------------------------------
GATCAGTTCATCATTC-1	TAAATTTGTT	TCGGCATGGACGAGCTGTACAAGTAAACGC
GCCAAATCATAGTAAG-1	TAACAACCCA	-----------GAGCTGTACAAGTAAACGC
AGGTCCGGTATAGGTA-1	TAACAAGTCC	TCGGCATGGACGAGCTGTACAAGTAAACGC
GCTTGAATCATCATTC-1	TAACAATAAA	------------------------------
GGGAGATAGCAGGTCA-1	TAACATGAAA	TCGGCATGGACGCGCTGTACAAGTAAACGC
CCTTACGTCGAATCCA-1	TAACCTGTCC	TCGGCATGGACGAGCTGTACAAGTAAACGC
GGCAATTAGAGCTGGT-1	TAACTGAGGT	------------------------------
GACGTGCTCCTCCTAG-1	TAACTTCAGT	TCGGCATGGACGAGCTGTACAAGTAAACGC
GTCAAGTGTGAGTGAC-1	TAAGCCTGAC	------------------------------
AACCATGTCATGTAGC-1	TAAGCGTAGG	TCGGCATGGACGAGCTGTACAAGTAAACGC
GCGAGAAAGCCAGTTT-1	TAAGCTTCGG	TCGGCATGGACGAGCTGTACAAGTAAACGC
AACACGTAGATGGCGT-1	TAAGGGATGT	------------------------------
TTAGTTCGTGAGTATA-1	TAAGGGCGTT	TCGGCATGGACGAGCTGTACAAGTAAACGC
GAAACTCAGTACACCT-1	TAAGTAACCG	TCGGCATGGACGAGCTGTACAAGTAAACGC
CCATGTCAGGGCTCTC-1	TAAGTCGAGT	TCGGCATGGACGAGCTGTACAAGTAAACGC
AGTGTCACATCTATGG-1	TAAGTCGGGG	------------------------------
GATGAAAGTACCCAAT-1	TAAGTCTCGA	TCGGCATGGACGAGCTGTACAAGTAAACGC
ACGCCAGCACAGAGGT-1	TAAGTTGTTT	TCGGCATGGACGAGCTGTACAAGTAAACGC
ATGAGGGTCCAACCAA-1	TAATAAGTGC	TCGGCATGGACGAGCTGTACAAGTAAACGC
ACGCCAGGTCGAATCT-1	TAATAATTCC	TCGGCATGGACGAGCTGTACAAGTAAACGC
CTCGGAGCAAGCCGTC-1	TAATACAGAG	TCGGC-------------------------
TCAGGTAGTAGCTTGT-1	TAATACATGG	------------------------------
CCGGTAGGTGTGACCC-1	TAATAGTCCT	------------------------AAACGC
TGTGGTAGTCCAACTA-1	TAATCTAACT	TCGGCATGGACGAGCTGTACAAGTAA----
CACATAGGTAGCTTGT-1	TAATCTGTGT	TCGGCATGGACGAGCTGTACAAGTAAACGC
AGCAGCCTCTACGAGT-1	TAATCTTGTC	TCGGCATGGACGAGCTGTACAAGTAAACGC
CCTAAAGGTTCAGTAC-1	TAATGCGTCT	TCGGCATGGACGAGCTGTACAAGTAAACGC
GCACTCTGTGGACGAT-1	TAATGTAGCA	---GCATGGACGAGCTGTACAAGTAAACGC
AGACGTTGTACCGCTG-1	TAATTCTCAG	TCGGCATGGACGAGCTGTACAAGTAAACGC
CAGCTGGAGACTCGGA-1	TAATTTCGTA	TCGGCATGGACGAGCTGTACAAGTAAACGC
TCAGGATCAAACGTGG-1	TAATTTGTTC	----------------------GTAAACGC
TCATTTGGTTCGAATC-1	TACAAACATA	------------------------------
TCTCATAGTCTCATCC-1	TACAAACCGC	TCGGCATGGACGAGCTGTACAAGTAAACGC
GCAAACTGTGTGACGA-1	TACAAATTGG	TCGGCATGGACGAGCTGTACAAGTAAACGC
GACGTTAAGCTGCGAA-1	TACAACACCA	------------------------AAACGC
TTGGCAACAGGCGATA-1	TACAAGGTAT	TCGGCATGGACGAGCTGTACAAGTAAACGC
GAGGTGACATGCCCGA-1	TACAATAATT	TCGGCATGGACGAGCTGTACAAGTAAACGC
CAGCAGCGTAAAGGAG-1	TACACAGGCT	TCGGCATGGACGAGCTGTACAAGTAAACGC
AAAGCAACACCGCTAG-1	TACACTTGTT	------------------------------
CTACGTCAGCTGCGAA-1	TACAGAATGG	TCGGCATGGACGAGCTGTACAAGTAAACGC
TTGCGTCAGTCGTTTG-1	TACAGTCTAC	TCGGCATGGACGAGCTGTACAAGTAAACGC
TCGTAGAAGATGCCTT-1	TACAGTGAAT	TCGGCATGGACGAGCTGTACAAGTAAACGC
CGTCTACAGGGTCGAT-1	TACATATTCT	TCGGCATGGACGAGCTGTACAAGTAAACGC
AGCGGTCCACTTAAGC-1	TACATCTGCG	TCGGCATGGACGAGCTGTACAAGTAAACGC
ACGATGTAGTCATGCT-1	TACCAAACGC	--------GACGAGCTGTACAAGTAAACGC
TACGGGCGTGGCCCTA-1	TACCAATTTC	TCGGCATGGACGAGCTGTACAAGTAAACGC
GAACCTACAGACGCAA-1	TACCCGAGAG	------------------------------
GGGCACTGTGCAGACA-1	TACCCTACTT	TCGGCATGGACGAGCTGTACAAGTAAACGC
AGTTGGTCACGGACAA-1	TACCGAGTAA	------------------------------
AACTCAGCAGCGTTCG-1	TACCGATCGT	TCGGCATGGACGAGCTGTACAAGTAAACGC
AAGCCGCCATAGACTC-1	TACCGGACCC	TCGGCATGGACGAGCTGTACAAGTAAACGC
CTGATCCAGTCATGCT-1	TACCTTTTCG	TCGGCATGGACGAGCTGTACAAGTAAACGC
ATCCGAACAGGTCTCG-1	TACGAACGAG	TCGGCATGGACGAGCTGTACAAGTAAACGC
GCATGCGAGCCAGTAG-1	TACGACCACA	------------------------------
CCTCTGACAGCGATCC-1	TACGAGCATG	TCGGCATGGACGAGCTGTACAAGTAAACGC
AGCCTAACAGACGCCT-1	TACGAGCCCG	---------------------AGTAAACGC
AAACGGGAGAAACCTA-1	TACGATATAA	------------------------------
GCGGGTTTCCTGCCAT-1	TACGCACCAG	------------------------------
ACTGTCCTCTTCATGT-1	TACGTCCACA	------------------------------
GTGGGTCAGGAGTTGC-1	TACGTTCTGT	------------------------------
GTAACGTAGTGCGTGA-1	TACGTTTGGG	------------------------------
CTCGTACAGAACAATC-1	TACTAAGTGC	TCGGCATGGACGAGCTGTACAAGTAAACGC
CACAGTAGTCGGCTCA-1	TACTACAAAA	TCGGCATGGACGAGCTGTACAAGTAAACGC
GTCATTTTCAAGATCC-1	TACTACAGCC	TCGGCATGGACGAGCTGTACAAGTAAACGC
CTAAGACCATGGATGG-1	TACTCGGGTT	TCGGCATGGACGAGCTGTACAAGTAAACGC
CGTCAGGGTTGCCTCT-1	TACTGACTCA	---------------------AGTAAACGC
CCTTACGTCGAGAACG-1	TACTGTCAAA	------------------------------
AAGTCTGGTAGCGTGA-1	TACTTATATT	TCGGCATGGACGAGCTGTACAAGTAAACGC
TCAGGATTCTGGTGTA-1	TACTTCTGCT	----------------GTACAAGTAAACGC
GTGCTTCTCCCATTTA-1	TACTTCTTTA	TCGGCATGGACGAGCTGTACAAG-------
GCTGCGACATACCATG-1	TAGAAATTCG	---------------------------CGC
CATTCGCCAAGCGATG-1	TAGAATTATA	TCGGCATGGACGAGCTGTACAAGTAAACGC
TGGCTGGCATACAGCT-1	TAGACTATGC	TCGGCATGGACGAGCTGTACAAGTAAACGC
TCAACGAGTCAGGACA-1	TAGAGGCTCA	TCGGCATGGACGAGCTGTACAAGTAAACGC
CTCGAGGTCGTAGGTT-1	TAGATAATGG	TCGGCATGGACGAGCTGTACAAGTAAACGC
AACCATGGTCTAGTGT-1	TAGATGGTCT	TCGGCATGGACGAGCTGTACAAGTAAACGC
GATCAGTAGCCACTAT-1	TAGCAAATGC	TCGGCATGGACGAGCTGTACAAGTAAACGC
ACTTTCACAGGGTACA-1	TAGCAATAAA	--------GACGAGCTGTACAAGAAAACGC
TTGTAGGCACGAGGTA-1	TAGCACTTTT	TCGGCATGGACGAGCTGTACAAGTAAACGC
ATCATCTTCTCCAGGG-1	TAGCATACCG	TCGGCATGGACGAGCTGTACAAGTAAACGC
TTCTCCTAGGCGTACA-1	TAGCATTCGG	------------------------------
AACCGCGTCTCGAGTA-1	TAGCCTTGTG	TCGGCATGGACGAGCTGTACAAGTAAACGC
AACTCAGGTTGTTTGG-1	TAGCGAGGAG	TCGGCATGGACGAGCTGTACAAGTAAACGC
ACTGTCCGTGTAAGTA-1	TAGCTTCTAT	-------GGACGAGCTGTACAAGTAAACGC
ACGGAGACAAGTAATG-1	TAGCTTGCAC	------------------------------
CTCTAATTCGCAGGCT-1	TAGCTTTATT	---GCATGGACGAGCTGTACAAGTAAACGC
CCTAAAGAGCCCAGCT-1	TAGCTTTCCC	------------------------------
CCTTACGGTTCTGAAC-1	TAGGACGCTT	TCGGCATGGACGAGCTGTACAAGTAAACGC
TAGGCATCACCGCTAG-1	TAGGACTTTG	------------------------------
AAGGTTCAGGCATGGT-1	TAGGCAAGGT	TCGGCATGGACGAGCTGTACAAGTAAACGC
TAGGCATAGACTACAA-1	TAGGCATCGC	------------------------------
AAGCCGCCATAGACTC-1	TAGGCCAGCG	TCGGCATGGACGAGCTGTACAAGTAAACGC
GAGCAGAAGATTACCC-1	TAGGCGGGCC	TCGGCATGGACGAGCTGTACAAGTAAACGC
AGCGGTCGTAGATTAG-1	TAGGCTATGG	----------------------GTAAACGC
TGTGGTAGTAATAGCA-1	TAGGTAAATG	------------------------------
CACTCCAAGAACAACT-1	TAGGTGGCGG	TCGGCATGGACGAGCTGTACAAGTAAACGC
AAGTCTGGTATAGGTA-1	TAGTAATAAC	TCGGCATGGACGAGCTGTAC----------
CCCATACTCAGTCAGT-1	TAGTATTAAT	TCGGCATGGACGAGCTGTACAAGTAAACGC
CACCTTGTCGCTTAGA-1	TAGTCCCGCG	TCGGCATGGACGAGCTGTACAAGTAAACGC
CCCAATCTCCGTCAAA-1	TAGTCGATTT	TCGGCATGGACGAGCTGTACAAGTAAACGC
GAGCAGACACCTGGTG-1	TAGTGACTTT	----------CGAGCTGTACAAGTAAACGC
CAAGAAAAGACAATAC-1	TAGTTACAGA	------------------------------
GTCCTCATCAACCATG-1	TAGTTCAGCT	TCGGCATGGACGAGCTGTACAAGTAAACGC
CACAGTACAGTCAGAG-1	TAGTTGTCCA	TCGGCATGGACGAGCTGTACAAGTAAACGC
CTCGAGGGTCGCTTCT-1	TAGTTTCGAT	TCGGCATGGACGAGCTGTACAAGTAAACGC
CGATGGCAGAGCCTAG-1	TATAACCAGA	------------------------------
ATTCTACCAGCCTATA-1	TATAAGGTAA	TCGGCATGGACGAGCTGTACAAGTAAACGC
CGGACACGTATTACCG-1	TATAATGTTC	-------------GCTGTACAAGTAAACGC
GCGCCAAAGACTAGGC-1	TATAATTACA	TCGGCATGGACGAGCTGTACAAGTAAACGC
GTCAAGTGTTAAGACA-1	TATACATGGT	------------------------------
TGACGGCGTCAATACC-1	TATACCAACA	---------------------AGTAAACGC
AGACGTTGTACTCAAC-1	TATACGGGGC	---------------------AGTAAACGC
CAACCAAGTCGAACAG-1	TATACTCCGA	------------------------------
CGTGTCTCACATGACT-1	TATAGAACCT	TCGGCATGGACGAGCTGTACAAGTAAACGC
TACACGAAGGGTATCG-1	TATAGCGCAA	------------------------------
GTACTCCAGCCCAATT-1	TATATATCCG	TCGGCATGGACGAGCTGTACAAGTAAACGC
CGCGGTAGTAGCCTAT-1	TATATCACCA	TCGGCATGGACGAGCTGTACAAGTAAACGC
GCGCAGTCATCCCACT-1	TATATCGCTA	------------------------------
CAAGTTGAGGTTACCT-1	TATATCTCGG	TCGGCATGGACGAGCTGTACAAGTAAACGC
AGCGGTCCACCTCGTT-1	TATATGTATT	TCGGCATGGACGAGCTGTACAAGTAAACGC
TTAACTCTCGATAGAA-1	TATATTATCT	------------------------------
TTAACTCTCGATAGAA-1	TATATTATCT	TCGGCATGGACGAGCTGTACAAGTAAACGC
CTACACCCAGACGCAA-1	TATATTTAAA	TCGGCATGGACGAGCTGTACAAGTAAACGC
GCGCGATGTTCATGGT-1	TATATTTTGC	TCGGCATGGACGAGCTGTACAAGTAAACGC
CAGCGACAGCAGGCTA-1	TATCACAGTC	TCGGCATGGACGAGCTGTACAAGTAAACGC
CGTTCTGGTTATTCTC-1	TATCACCATC	TCGGCATGGACG------------------
CTCGTACGTTCATGGT-1	TATCACTCAA	--------------CTGTACAAGTAAACGC
CTCGAAAGTCCAGTGC-1	TATCAGTCGA	TCGGCATGGACGAGCTGTACAAGTAAACGC
AGCATACTCGTAGGTT-1	TATCAGTCGC	------------------------------
ATGAGGGTCCAACCAA-1	TATCCACCTT	TCGGCATGGACGAGCTGTACAAGTAAACGC
TGGCGCAAGACTAGAT-1	TATCCGCATT	TCGGCATGGACGAGCTGTACAAGTAAACGC
CTACACCCATGGTAGG-1	TATCCGGAAA	------------------------------
CAGCTGGTCATCATTC-1	TATCCTGGCG	TCGGCATGGACGAGCTGTACAAGTAAACGC
TTGCGTCCATGCAACT-1	TATCCTTGAA	CCGGCATGGACGAGCTGTACAAGTAAACGC
TGTGTTTTCCACGTGG-1	TATCGACGAT	TCGGCATGGACGAGCTGTACAAGTAAACGC
ACACCAATCGGATGTT-1	TATCGTATTT	TCGGCATGGACGAGCTGTACAAGTAAACGC
TATTACCCACGCCAGT-1	TATCTGACGC	TCGGCATGGACGAG----------------
CTCTACGCACGCCAGT-1	TATCTTATCC	TCGGCATGGACGAGCTGTACAAGTAAACGC
GACACGCTCAGAGACG-1	TATCTTCCGT	TCGGCATGGACGAGCTGTACAAGTAAACGC
ACGCCAGTCCAAACAC-1	TATCTTGCCA	TCGGCATGGACGAGCTGTACAAGTAAACGC
CGGACGTGTGTGTGCC-1	TATGACCGTC	TCGGCATGGACGAGCTGTACAAGTAAACGC
TCATTTGTCGCTTAGA-1	TATGATGGTT	TCGGCATGGACGAGCTGTACAAGTAAACGC
TACTCATAGCTGATAA-1	TATGCAGAAG	TCGGCATGGACGAGCTGTACAAGTAAACGC
GACAGAGTCTCGAGTA-1	TATGCATTTT	TCGGCATGGACGAGCTGTACAAGTAAACGC
ATTACTCGTCACACGC-1	TATGCGACGC	----------------GTACAAGTAAACGC
TTGTAGGGTCGAACAG-1	TATGCGCCGG	TCGGCATGGACGAGCTGTACAAGTAAACGC
TCACAAGGTGTAAGTA-1	TATGGAAATT	-----------------------------C
AGCAGCCTCTACGAGT-1	TATGGCCATG	TCGGCATGGACGAGCTGTACAAGTAAACGC
GATGAAAGTGAAATCA-1	TATGGTCCTG	-----------GAGCTGTACAAGTAAACGC
CTCGGAGCAAGCCGCT-1	TATGTATTTT	TCGGCATGGACGAGCTGTACAAGTAAACGC
GGACAAGTCAAACAAG-1	TATGTCAGAT	TCGGCATGGACGAGCTGTACAAGTAAACGC
GGACAAGTCAAACAAG-1	TATGTCAGAT	TCGGCATGGACGAGCTGTACAAGTAAACGC
CTCTACGGTTCCACAA-1	TATGTTACTT	------------------------------
AAGGAGCTCATGTGGT-1	TATTAATTTT	TCGGCATGGACGAGCTGTACAAGTAAACGC
CATCAGAGTTACGACT-1	TATTACAGTT	TCGGCATGGACGAGCTGTACAAGTAAACGC
CGACTTCAGTGCGTGA-1	TATTACATAA	TCGGCATGGACGAGCTGTACAAGTAAACGC
CACCTTGTCGCTTAGA-1	TATTCGTTTA	TCGGCATGGACGAGCTGTACAAGTAAACGC
TTTGCGCGTTAGGGTG-1	TATTGAATAC	TCGGCATGGACGAGCTGTACAAGTAAACGC
GTGCAGCCATGAAGTA-1	TATTGACTTT	TCGGCATGGACGAGCTGTACAAGTAAACGC
ACGGAGATCGGCGCAT-1	TATTGATACA	TCGGCATGGACGAGCTGTACAAGTAAACGC
TTGTAGGAGTGGCACA-1	TATTGCGCTG	TCGGCATGGACGAGCTGTACAAGTAAACGC
AGGCCACGTGGCGAAT-1	TATTGCGGAG	TCGGCATGGACGAGCTGTACAAGTAAACGC
TCACGAAGTCCGTCAG-1	TATTGCTCTT	---------------------------CGC
CGAACATAGCTAACTC-1	TATTGGCTGA	TCGGCATGGACGAGCTGTACAAGTAAACGC
ACTGTCCGTGTAAGTA-1	TATTTAAAAC	TCGGCATGGACGAGCTGTACAAGTAAACGC
CAAGTTGGTTCACCTC-1	TATTTAGGTA	TCGGCATGGACGAGCTGTACAAGTAAACGC
TTAGTTCGTGAGTATA-1	TATTTATCTG	TCAGCATGGACGAGCTGTACAAGTAAACGC
CGTGTCTCACATGACT-1	TATTTATTTA	------------------------------
CAGCATAAGCCCGAAA-1	TATTTCAACC	------------------------------
CGTAGCGTCTAACTCT-1	TATTTCAACT	TCGGCATGGACGAGCTGTACAAGTAAACGC
GGGTTGCAGGCTAGAC-1	TATTTCGTCT	TCGGCATGGACGAGCTGTACAAGTAAACGC
TAAGCGTCACACATGT-1	TATTTCTGCG	TCGGCATGGACGAGCTGTACAAGTAAACGC
GCGGGTTTCGCGGATC-1	TATTTGAATG	------------------------------
TAGTGGTCACCCAGTG-1	TATTTGCTTT	TCGGCATGGACGAGCTGTACAAGTAAACGC
TCATTTGCACTCTGTC-1	TATTTGTGAA	TCGGCATGGACGAGCTGTACAAGTAAACGC
TCTCTAAGTTTAGGAA-1	TATTTGTGCA	TCGGCATGGACGAGCTGTACAAGTAAACGC
CATATGGGTCGAGTTT-1	TATTTTCCTT	TCGGCATGGACGAGCTGTACAAGTAAACGC
GTGAAGGTCGCGGATC-1	TATTTTCTCT	TCGGCATGGACGAGCTGTACAAGTAAACGC
TGTCCCAAGCCGCCTA-1	TATTTTGGCC	TCGGCATGGACGAGCTGTACAAGTAAACGC
CCTTACGTCGACAGCC-1	TCAAAAGAGT	TCGGCATGGACGAGCTGTACAAGTAAACGC
CCTTACGTCGACAGCC-1	TCAAAAGAGT	TCGGCATGGACGAGCTGTACAAGTAAACGC
CAGTCCTCAAGGGTCA-1	TCAAACAGCC	TCGGCATGGACGAGCTGTACAAGTAAACGC
ACGCCAGCACAGAGGT-1	TCAAAGACTT	-------------GCTGTACAAGTAAACGC
GCGCGATCAGGACGTA-1	TCAAATATCT	TCGGCATGGACGAGCTGTACAAGTAAACGC
TCAGCTCAGCTGCGAA-1	TCAATCATAT	TCGGCATGGACGAGCTGTACAAGTAAACGC
CACCTTGGTTAGATGA-1	TCAATTGTAT	TCGGCATGGACGAGCTGTACAAGTAAACGC
TACCTATAGGCTAGCA-1	TCAATTGTTT	TCGGCATGGACGAGCTGTACAAGTAAACGC
GTCCTCATCACCTCGT-1	TCACACCGTT	TCGGCATGGACGAGCTGTACAAGTAAACGC
ACCGTAACAGTAAGCG-1	TCACACTATT	TCGGCATGGACGAGCTGTACAAGTAAACGC
ACAGCTAAGATCCGAG-1	TCACATCTCT	TCGGCATGGACGAGCTGTACAAGTAAACGC
TGAGCCGAGTACGTAA-1	TCACATTGTC	TCGGCATGGACGAGCTGTACAAGTAAAC--
GTACGTACAAGACGTG-1	TCACCCGTTT	TCGGCATGGACGAGCTGTACAAGTAAACGC
CATGCCTAGGAGCGAG-1	TCACCCTCAA	TCGGC-------------------------
TATTACCTCTGAGTGT-1	TCACCGTAAG	------------------------------
GACGGCTAGCTAACTC-1	TCACCTATTA	------------------------------
TGTGGTAGTAATAGCA-1	TCACGGCAGG	------------------------------
GAGGTGAGTACATCCA-1	TCACGGTATT	TCGGCATGGACG------------------
AGAGCTTGTAGCGTGA-1	TCACTATACT	TCGGCATGGACGAGCTGTACAAGTAAACGC
ATGGGAGGTGAGTATA-1	TCACTCCAGT	---------------------------CGC
GACTACAAGTCTCCTC-1	TCACTCGCCT	------------------------------
AGGGAGTAGCTAAACA-1	TCACTCGCTT	TCGGCATGGACGAGCTGTACAAGTAAACGC
TGTGGTAAGAACAATC-1	TCACTCTGTC	----------------------GTAAACGC
GTGCAGCCATGAAGTA-1	TCACTGGGGT	TCGGCATGGACGAGCTGTACAAGTAAACGC
TTCTTAGCACATTAGC-1	TCACTGTTTA	------------------------------
AACTGGTCACATTCGA-1	TCAGACATTT	------------------------------
GCTGCAGTCAAGGTAA-1	TCAGACCCTA	TCGGCATGGACGAGCTGTACAAGTAAACGC
AGAGTGGAGGCAGGTT-1	TCAGAGGCAG	------------------------------
GCTTGAACATAACCTG-1	TCAGCAAGAC	TCGGCATGGACGAGCTGTACAAGTAAACGC
TACTTGTCATCACAAC-1	TCAGCGTATC	------------------------------
CCGTTCATCACATAGC-1	TCAGGATGAC	---------------TGTACAAGTAAACGC
CACCACTCATGCCTTC-1	TCAGGGCCAC	TCGGCATGGACGAGCTGTACAAGTAAA---
TCCACACAGGCTAGCA-1	TCAGGGCTTC	TCGGCATGGACGAGCTGTACAAGTAAACGC
CCTTCCCTCGTCCGTT-1	TCAGTAAGCG	TCGGCATGGACGAGCTGTACAAGTAAACGC
CAGAATCAGTCCCACG-1	TCAGTACTAG	TCGGCATGGACGAGCTGTACAAGTAAACGC
GCAGCCAGTACCGTAT-1	TCAGTATCTA	TCGGCATGGACGAGCTGTACAAGTAAACGC
TACACGACACAAGCCC-1	TCAGTATTAT	------------------------------
AACTGGTAGTGCGTGA-1	TCAGTTTTTG	TCGGCATGGACGAGCTGTACAAGTAAACGC
CTACGTCAGTCTCGGC-1	TCATAATATA	------------------------------
TGTATTCGTATATGAG-1	TCATAGTTGT	TCGGCATGGACGAGCTGTACAAGTAAACGC
CGAGCACTCTCTGCTG-1	TCATATCATG	TCGGCATGGACGAGCTGTACAAGTAAACGC
TGCTGCTTCGTTGACA-1	TCATATTGTA	------------------------------
GAATAAGAGATGCCAG-1	TCATATTTAA	TCGGCATGGACGAGCTGTACAAGTAAACGC
TAAGTGCCAACACCTA-1	TCATCGGCAG	------------------------------
CGGTTAAGTGGTCCGT-1	TCATCGGTTT	TCGGCATGGACGAGCTGTACAAGTAAACGC
CAAGAAAGTTGAGTTC-1	TCATCTTGAT	TCGGCATGGACGAGCTGTACAAGTAAACGC
TCAGATGAGTGGGCTA-1	TCATGAATGA	TCGGCATGGACGAGCTGTACAAGTAAACGC
TTCTACATCGTCCAGG-1	TCATGCAACA	TCGGCATGGGCGAGCTGTACAAGTAAACGC
CCTAGCTGTCTGATTG-1	TCATGCGGCA	---------ACGAGCTGTACAAGTAAACGC
CGGGTCATCAGATAAG-1	TCATGCTATT	TCGGCATGGACGAGCTGTACAAGTAAACGC
ACGGCCAGTTGGAGGT-1	TCATGGATAA	------------------------------
CGACTTCAGGCCGAAT-1	TCATGGATGA	TCGGCATGGACGAGCTGTACAAGTAAACGC
TTCTTAGCACATTAGC-1	TCATGGTCGT	TCGGCATGGACGAGCTGTACAAGTAAACGC
TCGGGACCATGCTGGC-1	TCATTCCATT	TCGGCATGGACGAGCTGTACAAGTAAACGC
TAAGCGTGTTTCGCTC-1	TCATTGCGTT	TCGGCATGGACGAGCTGTACAAGTAAACGC
TGACTTTGTATAGGGC-1	TCATTGGTTT	TCGGCATGGACGAGCTGTACAAGTAAACGC
TGCGGGTTCACTTACT-1	TCATTTCATG	-----------------------TAAACGC
TAAGAGATCAGAGACG-1	TCCAAAAACC	TCGGCATGGACGAGCTGTACAAGTAAACGC
CAGAGAGGTCAGGACA-1	TCCAACAGCA	------------------------------
TGCGCAGTCATTGCGA-1	TCCAACCCCA	TCGGCATGGACGAGCTGTACAAGTAAACGC
TGGGCGTGTATCAGTC-1	TCCAATCTTC	------------------------------
AACGTTGCAAAGTGCG-1	TCCACAACAG	--------------------------ACGC
CCCTCCTCACGGTGTC-1	TCCAGACGTT	------------------------------
TTGACTTTCCTGTAGA-1	TCCAGATAGG	------------------------------
CACAAACTCCAGAAGG-1	TCCAGTAAGT	TCGGCATGGACGAGCTGTACAAGTAAACGC
AGGGATGTCACTGGGC-1	TCCATCAAAC	TCGGCATGGACGAGCTGTACAAGTAAACGC
TGCGTGGAGAAGGTGA-1	TCCATCGGGG	TCGGCATGGACGAGCTGTACAAGTAAACGC
TAGGCATCACGTCTCT-1	TCCATCTAGT	TCGGCATGGACGAGCTGTACAAGTAAACGC
CAGAATCGTATATGAG-1	TCCCAGCGCT	TCGGCATGGACGAGCTGTACAAGTAAACGC
CATATGGCAAGCCATT-1	TCCCATATGT	------------------------------
CGCCAAGGTGGCTCCA-1	TCCCATTGAC	TCGGCATGGACGAGCTGTACAAGTAAACGC
AGCGTATTCATGCATG-1	TCCCCATCTT	TCGGCATGGACGAGCTGTACAAGTAAACGC
TGCGTGGGTAGTAGTA-1	TCCCCGACAT	TCGGCATGGACGAGCTGTACAAGTAAACGC
CAGAGAGCAAGCGAGT-1	TCCCCTGCGT	TCGGCATGGACGAGTTGTACAAGTAAACGC
TCGTAGACATCCTAGA-1	TCCCGACGGG	-------GGACGAGCTGTACAAGTAAACGC
CCCAATCGTCCATCCT-1	TCCCGCCTAC	TCGGCATGGACGAGCTGTACAAGTAAACGC
AGGCCGTGTTATGTGC-1	TCCCTCGTGG	------------------------------
CTTTGCGTCATCGGAT-1	TCCGACAGTA	------------------------------
CATGACAGTCTTGCGG-1	TCCGGATGTT	TCGGCATGGACGAGCTGTACAAGTAAACGC
CAGAATCCATGATCCA-1	TCCGTGAAGT	------------------------------
ACTTGTTAGCAGATCG-1	TCCGTTACCG	TCGGCATGGACGAGCTGTACAAGTAAACGC
ACAGCTAGTCACAAGG-1	TCCGTTCAAG	TCGGCATGGACGAGCTGTACAAGTAAACGC
GGCAATTGTTGTACAC-1	TCCTACTGAT	-----------------------------C
CTAGAGTCATGCGCAC-1	TCCTCAAAAT	------------------------------
GCGAGAATCCTCGCAT-1	TCCTCAGTAC	TCGGCATGGACGAGCTGTACAAGTAAACGC
CAGCCGACACGGTAAG-1	TCCTCCCTTG	------------------------------
CTAGCCTTCCAAACTG-1	TCCTCGCAAC	-CGGCATGGACGAGCTGTACAAGTAAACGC
CCGGGATTCCTAGGGC-1	TCCTCTCACC	TCGGCATGGACGAGCTGTACAAGTAAACGC
TGCGCAGAGCGTCTAT-1	TCCTGGTCTA	TCGGCATGGACGAGCTGTACAAGTAAACGC
CACCACTGTCTGGTCG-1	TCCTGTAGTA	TCGGCATGGACGAGCTGTACAAGTAAACGC
GTCAAGTGTAAGGATT-1	TCCTGTTCAT	TCGGCATGGACGAGCTGTACAAGTAAACGC
TGTTCCGAGTATGACA-1	TCCTTCTAAT	TCGGCATGAAAGAGCTGTACAAGTAAACGC
CACATTTTCTTGTACT-1	TCCTTGGTGT	TCGGCATGGACGAGCTGTACAAGTAAACGC
GTACTCCTCGAACTGT-1	TCCTTTATCA	TCGGCATGGACGAGCTGTACAAGTAAACGC
CAAGTTGGTTCACCTC-1	TCGACCTGCA	------------------------------
GCGACCATCTCTAGGA-1	TCGACGGCAT	------------------------------
AGAATAGCACTGTTAG-1	TCGATACTCT	------------------------------
TTGTAGGGTAGCAAAT-1	TCGATCTTTT	TCGGCATGGACGAGCTGTACAAGTAAACGC
GTCATTTCAGATCTGT-1	TCGATGCGCT	TCGGCATGGACGAGCTGTACAAGTAAACGC
GGACGTCGTGCTTCTC-1	TCGCAACAGT	TCGGCATGGACGAGCTGTACAAGTAAACGC
GGCTGGTTCGCGATCG-1	TCGCAGGTAG	------------------------------
CGGACTGAGAAACGAG-1	TCGCCAATAT	TCGGCATGGACGAGCTGTACAAGTAAACGC
AAGGCAGGTTCGCGAC-1	TCGCCCCTTC	TCGGCATGGACGAGCTGTACAAGTAAACGC
CTAAGACTCCGCAGTG-1	TCGCCCTATA	TCGGCATGGACGAGCTGTACAAGTAAACGC
ACGCCGACAAGTTGTC-1	TCGCCGTGAG	TCGGCATGGACGAGCTGTACAAGTAAACGC
GGTGCGTCACTGTCGG-1	TCGCTCATGG	TCGGCATGGACGAGCTGTACAAGTAAACGC
TGCCAAAGTGCATCTA-1	TCGCTCATTC	TCGGCATGGACGAGCTGTACAAGTAAACGC
TGGGAAGTCTACGAGT-1	TCGCTTGTAC	------TGGACGAGCTGTACAAGTAAACGC
TGTGGTAGTAATAGCA-1	TCGGAACCCA	TCGGCATGGACGAGCTGTACAAGTAAACGC
TACGGGCAGCAGGCTA-1	TCGGCAGTCC	TCGGCATGGACGAGCTGTACAAGTAAACGC
CGGAGCTAGAGGTTAT-1	TCGGCATGGC	TCGGCATGGACGAGCTGTACAAGTAAACGC
TTGAACGCAGACTCGC-1	TCGGCCGCAT	TCGGCATGGACGAGCTGTACAAGTAAACGC
GGCCGATAGAATGTTG-1	TCGGCCTGTG	TCGGCATGGACGAGCTGTACAAGTAAACGC
GTTCTCGTCCACTGGG-1	TCGGCTGTTG	TCGGCATGGACGAGCTGTACAAGTAAACGC
TGTATTCCAGTCAGAG-1	TCGGGAACTT	------------------------------
ATGCGATCAATCAGAA-1	TCGGGCGGTC	TCGGCATGGACGAGCTGTACAAGTAAACGC
TGACGGCGTACCAGTT-1	TCGGGTAGAC	TCGGCATGGACGAGCTGTACAAGTAAACGC
GTAGTCATCGAGAACG-1	TCGGGTGTCA	TCGGCATGGACGAGCTGTACAAGTAAACGC
CCGTACTGTGCAACTT-1	TCGGTGTTCT	------------------------------
TCATTTGGTCACTTCC-1	TCGTAACAGC	TCGGCATGGACGAGCTGTACAAGTAAACGC
CTAATGGGTTTGACTG-1	TCGTAATGGG	------------------------------
AAGCCGCCATAGACTC-1	TCGTACTTCT	TCGGCATGGACGAGCTGTACAAGTAAACGC
AGGGATGGTGTGACGA-1	TCGTAGGCTT	TCGGCATGGACGAGCTGTACAAGTAAACGC
TCGCGAGTCAGGCAAG-1	TCGTAGTGGT	------------------------------
GGACAGACAACGCACC-1	TCGTCATTAT	------------------------------
TACTTACTCGAACTGT-1	TCGTCCGGCC	TCGGCATGGACGAGCTGTACAAGTAAACGC
AGGTCCGAGCAATATG-1	TCGTTAGATT	TCGGCATGGACGAGCTGTACAAGTAAACGC
TCACAAGGTGTAAGTA-1	TCGTTATCTG	TCGGCATGGACGAGCTGTACAAGTAAACGC
TTAGTTCGTGCCTGTG-1	TCGTTCGCAG	TCGGCATGGACGAGCTGTACAAGTAAACGC
AGGGATGAGTTTCCTT-1	TCGTTGAATG	TCGGCATGGACGAGCTGTACAAGTAAACGC
CGCTGGAGTTTGTTGG-1	TCGTTGGTAA	TCGGCATGGACGAGCTGTACAAGTAAACGC
TAGTGGTCACGTGAGA-1	TCGTTTCAGT	-------------------------AACGC
TACGGGCAGCAGGCTA-1	TCGTTTGAAT	TCGGCATGGACGAGCTGTACAAGTAAACGC
CTGTTTAGTCCTCTTG-1	TCGTTTTCCC	-------------GCTGTACAAGTAAACGC
ATCCGAACAGGGTTAG-1	TCTAAAATAG	TCAGCATGGACGAGCTGTACAAGTAAACGC
CCGTTCAGTCCCGACA-1	TCTAAAGCAC	TCGGCATGGACGAGCTGTACAAGTAAGCGC
TATCAGGTCAGCGATT-1	TCTAACCTAA	TCGGCATGGACGAGCTGTACAAGTAAACGC
TCTCTAAAGCAGCGTA-1	TCTAAGTACA	TAGGCATGGACGAGCTGTACAAGTAAACGC
TTCGAAGTCCTCTAGC-1	TCTAATAAAT	------------------------------
CGTGTAAAGATCCGAG-1	TCTAATACAT	------------------------------
CGTCTACAGTGGGATC-1	TCTAATTCAT	------------------------------
CATTATCAGCCACCTG-1	TCTAATTTCT	------------------------------
GGACATTCATCACGTA-1	TCTACAACGT	TCGGCATGGACGAGCTGTACAAGTAAACGC
TGGCCAGAGTGGAGTC-1	TCTACCTATA	TCGGCATGGACGAGCTGTACAAGTAAACGC
GAAACTCTCACATAGC-1	TCTACGGGGG	------------------------------
ACGATACTCTCGCTTG-1	TCTACTTAGA	---------------------AGTAAACGC
GCTGCGAGTGATAAAC-1	TCTAGAGGCC	TCGGCATGGACGAGCTGTACAAGTAAACGC
TTTGGTTTCAACGCTA-1	TCTAGATTTT	TCGGCATGGACGAGCTGTACAAGTAAACGC
GACGGCTGTGCAACGA-1	TCTAGCGCTG	TCGGCATGGACGAGCTGTACAAGTAAACGC
CCTATTAAGACTTGAA-1	TCTATAAACT	------------------------------
ATCCGAAGTCGCCATG-1	TCTATAGGCT	TCGGCATGGACGAGCTGTACAAGTAAACGC
GTATTCTCACGGTTTA-1	TCTATATTGT	TCGGCATGGACG------------------
GATCTAGTCCTATTCA-1	TCTATGACTG	TCGGCATGGACGAGCTGTACAAGTAAACGC
AACTCTTCAAGCCGCT-1	TCTATGGGTC	TCGGCATGGACGAGCTGTACAAGTAAACGC
TGGACGCCAGTAAGCG-1	TCTATTCATG	TCGGCATCGACGAGCTGTACAAGTAAACGC
CAACCTCTCTGGAGCC-1	TCTCAATTAG	TCGGCATGGACGAGCTGTACAAGTAAACGC
TCTTTCCCATCCCACT-1	TCTCACACTT	------------------------------
CAGCATAGTTACCGAT-1	TCTCACAGCG	TCGGCATGGACGAGCTGTACAAGTAAACGC
CACCACTGTCACTTCC-1	TCTCACGAAC	TCGGCATGGACGAGCTGTACAAGTAAACGC
CTGTTTACACTTAACG-1	TCTCAGCATA	TCGGCATGG---------------------
CGATGGCGTAAATACG-1	TCTCAGGATA	TCGGCATGGACGAGCTGTACAGGTAAACGC
CTGCCTACATGCCTTC-1	TCTCCACCGG	------------------------------
TTAGGACCAAGTACCT-1	TCTCCCCGGT	TCGGCATGGACGAGCTGTACAAGTAAACGC
GCGCCAACACGTGAGA-1	TCTCCGTAAC	------------------------------
TAGGCATAGGAACTGC-1	TCTCCTTCAC	TCGGCATGGACGAGCTGTACAAGTAAACGC
AGGGAGTTCTAACGGT-1	TCTCGATGTG	TCGGCATGGACGAGCTGTACAAGTAAACGC
CACAGTACAGTCAGAG-1	TCTCGATTTG	TCGGCAAGCACGAGCTGTACAAGTAAACGC
TGAGCATTCACAAACC-1	TCTCGTAACG	TCGGCATGGACGAGCTGTACAAGTAAACGC
TTTGGTTTCAACGCTA-1	TCTCTCAACT	TCGGCATGGACGAGCTGTACAAGTAAACGC
TGGGCGTTCGAGAGCA-1	TCTCTGGACA	TCGGCATGGACGAGCTGTACAAGTAAACGC
GGGATGAGTTAAGTAG-1	TCTCTTTGGG	TCGGCATGGACGAGCTGTACAAGTAAACGC
TGCCAAAAGAGTGAGA-1	TCTGACAATA	TCGGCATGGACGAGCTGTACAAGTAAACGC
CACATAGGTAGCTTGT-1	TCTGCACCTT	AAAACATGGAAGAGCTGTACAAGTAAACGC
CCTACACTCTGAGGGA-1	TCTGCATTAC	TCGGCATGGACGAGCTGTACAAGTAAACGC
GTTCATTTCGCGATCG-1	TCTGCCATGC	TCGGCATGGACGAGCTGTACAAGTAAACGC
TGAAAGAAGCACGCCT-1	TCTGCCATGT	TCGGCATGGACGAGCTGTACAAGTAAACGC
TTCTCAAGTAGCTGCC-1	TCTGCTTCCA	TCGGCATGGACGAGCTGTACAAGTAAACGC
GCGACCATCTCTAGGA-1	TCTGTAGGTT	------------------------------
TCGGGACCATGCTGGC-1	TCTGTCGTCA	------------------------------
TGGCGCATCTGCGTAA-1	TCTGTGAATT	TCGGCATGGACGAGCTGTACAAGTAAACGC
GTCACAAAGCACAGGT-1	TCTGTTCAGT	TCGGCATGGACGAGCTGTACAAGTAAACGC
TACCTATAGGCGCTCT-1	TCTGTTCGAA	TC----------------------------
CACCAGGTCACGGTTA-1	TCTGTTCGTT	TCGGCATGGACGAGCTGTACAAGTAAACGC
GAAGCAGGTGCCTGCA-1	TCTTAAAGCT	TCGGCATGGACGA-----------------
CGTGTAACAGCTGTAT-1	TCTTAAGTGG	TCGGCATGGACGAGCTGTACAAGTAAACGC
CGCTATCGTTACGGAG-1	TCTTAGCGTG	TCGGCATGGACGAGCTGTACAAGTAAACGC
TATCTCATCCACTCCA-1	TCTTAGGTCC	TCGGCATGGACGAGCTGTACAAGTAAACGC
CAGTAACCAAGACGTG-1	TCTTAGTTGC	TCGGCATGGACGAGCTGTACAAGTAAACGC
TGTGTTTTCCTAGAAC-1	TCTTATCTAT	TCGGCATGGACGAGCTGTACAAGTAAACGC
CCATTCGTCAGAGGTG-1	TCTTCAATTT	TCGGCATGGACGAGCTGTACAAGTAAACGC
GATTCAGTCATCTGCC-1	TCTTCCCAAA	------------------------------
TCAACGATCACATAGC-1	TCTTCCTAAA	TCGGCATGGACGAGCTGTACAAGTAAACGC
CGATTGAAGGATGTAT-1	TCTTCGTAAC	TCGGCATGGACGAGCTGTACAAGTAAACGC
CAGCTAAGTAGGACAC-1	TCTTCTAAGT	TCGGCATGGACGAGCTGTACAAGTAAACGC
CCTTACGGTTCTGAAC-1	TCTTGACAAC	TCGGCATGGACGAG----------------
TACTTGTGTTATCACG-1	TCTTGACCAA	----------------------------GC
AGTCTTTAGGGTATCG-1	TCTTGATTAC	CCGGCATGGCCGACCTGTACAGTTAAACGG
AACGTTGAGACAATAC-1	TCTTTAACCG	TCGGCATGGACGAGCTGTACAAGTAAACGC
CACACAAGTGTTAAGA-1	TCTTTAAGTT	TCGGCATGGACGAGCTGTACAAGTAAACGC
TACCTATTCGCTAGCG-1	TCTTTACGTA	TCGGCATGGACGAGCTGTACAAGTAAACGC
CAAGGCCCATGCAACT-1	TCTTTAGCCA	TCGGCATGGACGAGCTGTACAAGTAAACGC
TTTGCGCCATGCCTAA-1	TCTTTAGTCT	TCGACATGAACAAGCTGTACAAGTAAACGC
TAGAGCTAGTTAACGA-1	TCTTTAGTTT	TCGGCATGGACGAGCTGTACAAGTAAACGC
GGTGAAGGTAGCGCAA-1	TCTTTCAATG	TCGGCATGGACGAGCTGTACAAGTAAACGC
GTCTTCGAGCGTGAGT-1	TCTTTCATGG	------------------------------
TAGTTGGGTGAGTATA-1	TCTTTCCTTG	TCGGCATGGACGAGCTGTACAAGTAAACGC
GGGCACTGTGCAGACA-1	TCTTTCGGTC	TCGGCATGGACGAGCTGTACAAGTAAACGC
GTGCAGCCATGAAGTA-1	TCTTTCTCCT	----------------GTACAAGTAAACGC
CTCGGGAGTAGAAGGA-1	TCTTTCTTAC	------------------------------
TCCCGATCATGGATGG-1	TCTTTTAATT	TCGGCATGGACGAGCTGTACAAGTAAACGC
ACGTCAAAGTTACCCA-1	TCTTTTCTGC	TCGGCATGGACGAGCTGTACAAGTAAACGC
ACGGAGATCAACCAAC-1	TCTTTTGAGC	TCGGCATGGACGAGCTGTACAAGTAAACGC
GTGTTAGGTTCGTCTC-1	TCTTTTGGGT	TCGGCATGGACGAGCTGTACAAGTAAACGC
CCGTTCATCACATAGC-1	TGAAAGGCAA	------------------------------
ACACCAATCGGATGTT-1	TGAACACAAT	------------------------TCGGCA
GTAACTGAGCACCGTC-1	TGAACATATT	TCGGCATGGACGAGCTGTACAAGTAAACGC
TTGTAGGGTAGCAAAT-1	TGAACGAGTG	------------------------------
AAAGTAGCACATGACT-1	TGAATCGCGT	TCGGCATGGACGAGCTGTACAAGTAAACGC
ACTATCTTCCGTTGTC-1	TGAATTTACG	TCGGCATGGACGAGCTGTACAAGTAAACGC
ACACCCTAGTACCGGA-1	TGACACAAAT	TCGGCATGGACGAGCTGTACA---------
GATGAGGCATAGGATA-1	TGACACACCG	------------------------------
AGTAGTCGTCTTCTCG-1	TGACAGGAAT	------------------------------
TACGGGCAGACGCTTT-1	TGACCCGCTG	TCGGCATGGACGAGCTGTACAAGTAAACGC
CACAGTAGTGTAACGG-1	TGACCGGAGC	TTGGCATGGACGAGCTGTACAAGTAAACGC
TGGCGCATCCACGACG-1	TGACCTTATT	-------------GCTGTACAAGTAAACGC
ATTATCCTCCAATGGT-1	TGACTAAGCC	---------------------------CGC
TGTCCCAGTCTTGTCC-1	TGACTCTGGT	TCGGCATGGACGAGCTGTACAAGTAAACGC
AGTGAGGCAACACCTA-1	TGAGTTAGCT	---GCATGGACGAGCTGTACAAGTAAACGC
TTGGCAAAGGAGTCTG-1	TGAGTTTAGG	TCGGCATGGACGAGCTGTACAAGTAAACGC
TTGTAGGAGTTACCCA-1	TGATAGACAC	TCGGCATGGACGAGCTGTACAAGTAAACGC
CGTGTCTCACATGACT-1	TGATAGCCTA	TCGGCATGGACGAGCTGTACAAGTAAACGC
TGTATTCTCACCATAG-1	TGATAGTCAT	--------------CTGTACAAGTAAACGC
AGGGATGCACGAAATA-1	TGATAGTTTG	TCGGCATGGACGAGCTGTACAAGTAAACGC
TTAACTCGTTAAGTAG-1	TGATGATCAA	------------------------------
TCATTTGCACTCTGTC-1	TGATGTCATT	TCGGCATGGACGAGCTGTACAAGTAAACGC
GATGAAATCTGCTGTC-1	TGATGTTTTT	------------------------------
TATCAGGTCAGCGATT-1	TGATTAGTAT	TCGGCATGGACGAGCTGTACAAGTAAACGC
TCAACGAAGTGGACGT-1	TGATTAGTAT	TCGGCATGGACGAGCTGTACAAGTAAACGC
CACATAGGTTCCAACA-1	TGATTCCTTT	TCGGCATGGACGAGCTGTACAAGTAAACGC
CATCGAACATTGCGGC-1	TGATTGAGTT	TCGGCATGGACGAGCTGTACAAGTAAACGC
CGGTTAAGTACATGTC-1	TGATTTGTTA	---------------------AGTAAACGC
CTCGGGAAGACCGGAT-1	TGATTTTGGT	------------------------------
TACCTATTCAGAGACG-1	TGCAAAGTGG	------------------------------
CGGCTAGCACTCTGTC-1	TGCACGCACA	TCGGCATGGACGAGCTGTACAAGTAAACGC
CATCAGAAGGGTATCG-1	TGCAGGCCTT	TCGGCATGGACGAGCTGTACAAGTAAACGC
ACGGAGAGTTATCACG-1	TGCAGGGTGC	TCGGCATGGACGAGCTGTACAAGTAAACGC
CACATTTCATGCAATC-1	TGCAGTCTTG	TCGGCATGGACGAGCTGTACAAGTAAACGC
CGAGAAGTCTGTCCGT-1	TGCAGTTGCG	------------------------------
CGTTGGGAGGGATCTG-1	TGCCACCTTT	------------------------------
CATGACAAGTAGCCGA-1	TGCCAGGGGT	------------------------------
GCGACCACAGTGGAGT-1	TGCCCTGGTA	------------------------------
GACGGCTGTATCTGCA-1	TGCCTAAATC	------------------------------
GAATGAAAGCGAAGGG-1	TGCCTTGACT	TCGGCATGGACGAGCTGTACAAGTAAACGC
GCGACCATCTCTAGGA-1	TGCGAATTTG	TCGGCATGGACGAGCTGTACAAGTAAACGC
GTGCATACATGTTCCC-1	TGCGATTAAC	TCGGCATGGACGAGCTGTACAAGTAAACGC
GGGCACTTCGTTTAGG-1	TGCGGACAAA	TCGGCATGGACGAGCTGTACAAGTAAACGC
AGAATAGCACTGTTAG-1	TGCGGGTCAG	TCGGCATGGACGAGCTGTACAAGTAAACGC
AAGTCTGGTGTTGGGA-1	TGCGTTTAGT	TCGGCATGGACGAGCTGTACAAGTAAACGC
GAGCAGAAGGACAGAA-1	TGCTACCCCT	-----ATGGACGAGCTGTACAAGTAAACGC
GTTCGGGAGCCACGCT-1	TGCTAGACGC	TCGGCATGGACGAGCTGTACAAGTAAACGC
GGAGCAACACGAGAGT-1	TGCTAGCTGA	-----------------TACAAGTAAACGC
GTACTCCAGAGGTTAT-1	TGCTCCACGC	------------------------------
TTCTCCTAGGCGTACA-1	TGCTGTCCCT	TCGGCATGGACGAGCTGTACAAGTAAACGC
GGGAATGGTAGCGCAA-1	TGCTGTTTCT	------------------------------
AACACGTAGTGTCCCG-1	TGCTTAAGCT	TCGGCATGGACGAGCTGTACAAGTAAACGC
AAAGCAAGTCGATTGT-1	TGCTTATGCT	TCGGCATGGACGAGCTGTACAAGTAAACGC
GAACATCCATCCGGGT-1	TGCTTATTAG	------------------------------
ATCTGCCAGGGAAACA-1	TGCTTCGGAG	TCGGCATGGACGAGCTGTACAAGTAAACGC
AGAGCTTGTCGCGTGT-1	TGCTTGGGCC	TCGGCATGGACGAGCTGTACAAGTAAACGC
GTTCGGGAGCCACGCT-1	TGGAAACGCG	TCGGCATGGACGAGCTGTACAAGTAAACGC
GCGCCAAAGACTAGGC-1	TGGAAGGGGA	------------------------------
ATCATCTTCTCCAGGG-1	TGGAATAACA	--------------------AAGTAAACGC
ACCCACTGTATGAATG-1	TGGACTACAA	TCGGCATGGACGAGCTGTACAAGTAAACGC
AACTCTTCAAGTAGTA-1	TGGACTGCAG	TCGGCATGGACGAGCTGTACAAGTAAACGC
GTAGTCAGTTTGCATG-1	TGGAGATATA	TCGGCATGGACGAGCTGTACAAGTAAACGC
GGGAGATAGCAGGTCA-1	TGGAGGACAT	------------------------------
CATCCACCAGTCACTA-1	TGGAGTAGGC	TCGGCATGGACGAGCTGTACAAGTAAACGC
CCGTTCAAGCTTCGCG-1	TGGATCCGGC	TCGGCATGGACGAGCTGTACAAGTAAACGC
TGTCCCAGTACTCAAC-1	TGGATCTACA	---GCATGGACGAGCTGTACAAGTAAACGC
GCAGTTAAGTACGCCC-1	TGGATTAGTT	TCGGCATGGACGAGCTGTACAAGTAAACGC
AAAGTAGAGAGCTGGT-1	TGGATTTAAC	------------------------------
TAGAGCTGTTGCGCAC-1	TGGATTTCTA	------------------------------
GACACGCCATGGATGG-1	TGGATTTTCC	TCGGCATGGACGAGCTGTACAAGTAAACGC
CACAGTACAGTCAGAG-1	TGGCAATTCG	TCGGCATGGACGAGCTGTACAAGTAAACGC
GAGTCCGCACCGGAAA-1	TGGCAGCCTA	TCGGCATGGACGAGCTGTACAAGTAAACGC
ACCCACTGTTTGTTTC-1	TGGCATCACG	----------------------GTAAACGC
CACCTTGGTTAGATGA-1	TGGCCAAGAA	------------------------------
AGGCCACAGCTAACAA-1	TGGCCACGGA	------------------------------
ACGGAGAAGTTAGCGG-1	TGGCCTATTA	------------------------------
CGTTCTGAGCCACGCT-1	TGGCCTGCCT	TCGGCATGGACGAGCTGTACAAGTAAACGC
GACGCGTCATAGACTC-1	TGGCGAACGC	-------------GCTGTACAAGTAAACGC
CACCACTGTCTTCAAG-1	TGGCGCGGTA	TCGGCATGGACGAGCTGTACAAGTAAACGC
TACTCGCAGTATTGGA-1	TGGCGCTGAT	--------------------AAGTAAACGC
GCAATCAGTGCGAAAC-1	TGGCTAATGG	TCGGCATGGACGAGCTGTACAAGTAAACGC
CTCGTACAGAACAATC-1	TGGCTGCTAG	TCGGCATGGACGAGCTGTACAAGTAAACGC
TGTGTTTTCCTAGAAC-1	TGGCTGTAAG	------------AGCTGTACAAGTAAACGC
CGGAGTCCAGCTCGCA-1	TGGGCAATGG	------------------------------
CGGAGTCCAGCTCGCA-1	TGGGCAATGG	TCGGCATGGACGAGCTGTACAAGTAAACGC
CCCATACTCCTCCTAG-1	TGGGCCAGTC	TCGGCATGGACGAGCTGTACAAGTAAACGC
AGCTCCTGTCAGGACA-1	TGGGCGCGCC	TCGGCATGGACGAGCTGTACAAGTAAACGC
ACGGAGATCTCAAACG-1	TGGGGCGTAG	TCGGCATGGA--------------------
TGGGCGTTCCGTCATC-1	TGGGGGTTTT	------------------------------
CACACAACAGGGAGAG-1	TGGGTATCAT	TCGGCATGGACGAGCTGTACAAGTAAACGC
AAACCTGGTGTTGAGG-1	TGGGTTGCAC	--GGCATGGACGAGCTGTACAAGTAAACGC
TAGTTGGCAAGGACTG-1	TGGTAGCTTC	TCGGCATGGACGAGCTGTACAAGTAAACGC
CAGCGACAGGCTACGA-1	TGGTATTACC	------------------------AAACGC
TGCGTGGCACAGCCCA-1	TGGTCTCCGC	------------------------------
AACGTTGAGACAATAC-1	TGGTGTTTTT	------------------------------
ACTGTCCGTGCCTTGG-1	TGGTTCCTCC	TCGGCATGGACGAGCTGTACAAGTAAACGC
ACACTGATCTCGTTTA-1	TGGTTCGCAA	-------GGACGAGCTGTACAAGTAAACGC
CAGAGAGAGAGGTAGA-1	TGGTTGAATT	TTGGCATGGACGAGCTGTACAAGTAAACGC
CGGTTAATCGTCACGG-1	TGGTTGGGAC	TCGGCATGGACGAGCTGTACAAGTAAACGC
TCAGGATAGGGCTTCC-1	TGGTTTTTGG	TCGGCATGGACGAGCTGTACAAGTAAACGC
GACAGAGAGCTGGAAC-1	TGTAACTCCT	------------------------AAACGC
CACAGTACAGTCAGAG-1	TGTAAGGGCA	TCGGCATGGACGAGCTGTACAAGTAAACGC
GGCTCGAAGATGGGTC-1	TGTAATTGCG	TCGGCATGGACGAGCTGTACAAGTAAACGC
TCTTCGGTCCACTCCA-1	TGTAGCTCAG	TCGGCATGGACGAGCTGTAGAAGTAAACGC
AAACGGGAGGTAAACT-1	TGTATAAGTA	TCGGCATGGACGAGCTGTACAAGTAAACGC
GATCGTACATGGTAGG-1	TGTATATCAG	------------------------------
TTGCGTCAGTCGTTTG-1	TGTATCATGT	TCGGCATGGACGAGCTGTACAAGTAAACGC
TGGGCGTTCAAGAAGT-1	TGTATCCCGT	TCGGCATG----------------------
GTACTCCCAGTTTACG-1	TGTATGGGGT	TCGGCATGGACGAGCTGTACAAGTAAACGC
GCTCCTAAGCGAGAAA-1	TGTATGTAAC	TCGGCATGGACGAGCTGTACAAGTAAACGC
CCTTACGTCGACAGCC-1	TGTCACGTCA	TCG---------------------------
CTCGTACGTTATCGGT-1	TGTCAGCATT	TCGGCATGGACGAGCTGTACAAGTAAACGC
TGAAAGATCAGTACGT-1	TGTCATCTTT	TCGGCATGGACGAGCTGTACAAGTAAACGC
TGCTGCTTCACCGTAA-1	TGTCATGACG	TCGGCATGGACGAGCTGTACAAGTAAACGC
CCAGCGAGTGTAAGTA-1	TGTCATTATG	------------------------------
GCATGCGCAAATCCGT-1	TGTCCATTTA	------------------------------
AGTCTTTCATGCAACT-1	TGTCCCCCGG	-------------------------AACGC
CCTTACGAGGAGCGTT-1	TGTCCCTATT	TCGGCATGGACGAGCTGTACAAGTAAACGC
TGGTTCCCACACAGAG-1	TGTCCGGGTT	------------------------------
ACTGATGTCGCCAGCA-1	TGTCCTCGGC	------------------------------
TCTTCGGGTAAACACA-1	TGTCCTCGGT	TCGGCATGGACGAGCTGTACAAGTAAACGC
ACGTCAAAGTTACCCA-1	TGTCCTTCGT	TCGGCATGGACGAGCTGTACAAGTAAACGC
GATGCTATCGCCAAAT-1	TGTCCTTGGG	TCGGCATGGACGAGCTGTACAAGTAAACGC
CTGAAGTTCCCTTGCA-1	TGTCGATCAC	TCGGCATGGACGAGCTGTACAAGTAAACGC
TGGCGCAAGAATTCCC-1	TGTCGGTCTT	TCGGCATGGACGAGCTGTACAAGTAAACGC
CACATTTAGTGGGCTA-1	TGTCTACTGT	TCGGCATGGACGAGCTGTACAAGTAAACGC
CGGACACAGGACACCA-1	TGTCTAGACT	------------------------------
TAGGCATTCTGTACGA-1	TGTCTCACTA	TCGGCATGGACGAGCTGTACAAGTAAACGC
CCTACACTCTGAGGGA-1	TGTCTCTGCG	TCGGCATGGACGAGCT--------------
AAAGCAACAAATTGCC-1	TGTGACACTC	TCGGCATGGACGAGCTGTACAAGTAAACGC
CACACAACAGGGAGAG-1	TGTGATCACA	TCGGCATGGACGAGCTGTACAAGTAAACGC
GGGTTGCTCTGTTGAG-1	TGTGATCTTA	-----------GAGCTGTACAAGTAAACGC
GGACAGAAGGCACATG-1	TGTGCAACAT	TCGGCATGGACGAGCTGTACAAGTAAACGC
CCGTACTCATTCTCAT-1	TGTGCAGTCC	------------------------------
TTGTAGGAGGGAGTAA-1	TGTGCTGTTT	------TGGACGAGCTGTACAAGTAAACGC
CTAGCCTTCCAAACTG-1	TGTGGTTCCT	TCGGCATGGACGAGCTGTACAAGTAAACGC
CGTCTACAGGCATTGG-1	TGTGGTTGTG	TCGGCATGGACGAGCTGTACAAGTAAACGC
GTTCTCGCACCCATTC-1	TGTGTATTGT	TCGGCATGGACGAGCTGTACAAGTAAACGC
GTCAAGTTCTACTTAC-1	TGTGTGCTTT	------------------------AAACGC
CTCATTATCATTGCGA-1	TGTTATATGT	TCGGCATGGACGAGCTGTACAAGTAAACGC
CTCGTCAGTAAAGTCA-1	TGTTATGCTT	TCGGCATGGACGAGCTGTACAAGTAAACGC
TCAGATGCACATCCGG-1	TGTTATGGTG	TCGGCATGGACGAGCTGTACAAGTAAACGC
AGGTCCGTCCTACAGA-1	TGTTATTATT	TCGGCATGGACGAGCTGTACAAGTAAACGC
AAAGTAGTCCCAAGTA-1	TGTTATTTGG	TCGGCATGGACGAGCTGTACAAGTAAACGC
ACCTTTACACGTGAGA-1	TGTTCAAATT	TCGGCATGGACGAGCTGTACAAGTAAACGC
GACAGAGAGTGTACCT-1	TGTTCAATCT	TCGGCATGGACGAGCTGTACAAGTAAACGC
AGTAGTCCAGCCTTTC-1	TGTTGCCGTA	TCGGCATGGACGAGCTGTACAAGTAAACGC
GGTATTGCACCCATTC-1	TGTTGGTCAT	TCGGCATGGACGAGCTGTACAAGTAAACGC
TTAACTCTCATCACCC-1	TGTTGTATTG	----CATGGACGAGCTGTACAAGTAAACGC
TGCGTGGAGATGGCGT-1	TGTTGTTGAG	------------------------------
TATTACCAGTTGTCGT-1	TGTTGTTTTT	TCGGCATGGACGAGCTGTACAAGTAAACGC
ATCCGAACACCCATTC-1	TGTTTACGTA	TCGACATGGACGAGCTGTACAAGTAAACGC
TGCCCTATCCCATTAT-1	TGTTTCCTTG	------------------------------
ACGGGCTTCAAAGACA-1	TGTTTGGATC	TCGGCATGGACGAGCTGTACAAGTAAACGC
CGGTTAAGTGTTCGAT-1	TGTTTTTATC	------------------------------
CGAATGTTCCTTAATC-1	TTAAATATCT	TCGGCATGGACGAGCTGTACAAGTAAACGC
CTCGTACAGTGTACGG-1	TTAACCTTGT	TCGGCATGGACGAGCTGTACAAGTAAACGC
ACCTTTACAACTTGAC-1	TTAACTGCTT	------------------------------
ACCTTTACAACTTGAC-1	TTAACTGGCT	--------------------AAGTAAACGC
GTAACGTGTATTACCG-1	TTAACTTCCC	------------------------------
ACACCCTAGACCACGA-1	TTAAGATTGT	TCGGCATGGACGAGCTGTACAAGTAAACGC
AACCATGAGGTGTGGT-1	TTAAGCAATT	------------------------------
AAAGTAGAGCTACCTA-1	TTAAGCATCG	TCGGCATGGACGAGCTGTACAAGTAAACGC
AGGCCGTAGTTGTCGT-1	TTAAGCTTCC	TCGGCATGGACGAGCTGTACAAGTAAACGC
AGCAGCCAGGCTCAGA-1	TTAAGTCTCG	--------GACGAGCTGTACAAGTAAACGC
CTCGGAGCAGGACCCT-1	TTAAGTCTTA	TCGGCATGGACGAGCTGTACAAGTAAACGC
TGTCCCAGTCTTGTCC-1	TTAATAGGGA	--GGCATGGACGAGGTGTACAAGTAAACGC
AACACGTAGACTCGGA-1	TTAATCCATC	------------------------------
TACACGAAGTCAAGGC-1	TTAATCTGTG	TCGGCATGGACGAGCTGTACAAGTAAACGC
CGTCAGGGTCTCCCTA-1	TTAATGAGGT	------------------------------
CTCGGAGGTAATTGGA-1	TTAATGGGAG	TCGGCATGGACGAGCTGTACAAGTAAAAGC
AACCATGCACCTCGTT-1	TTAATTAGTT	TCGGCATGGACGAGCTGTACAAGTAAACGC
CTGTTTAGTCCTCTTG-1	TTACAATTAT	TCGGCATGGACGAGCTGTACAAGTAAACGC
CACTCCATCATACGGT-1	TTACACTGGG	TCGGCATGGACGAGCTGTACAAGTAAACGC
AGCAGCCAGCCGTCGT-1	TTACATACCA	TCGGCATGGACGAGCTGTACAAGTAAACGC
TCATTTGCACTCTGTC-1	TTACATTCAC	------------------------------
TCACGAATCAGCCTAA-1	TTACCACGGG	TCGGCATGGACGAGCTGTACAAGTAAACGC
GAATAAGTCAGAGACG-1	TTACCATGTG	-----------------TACAAGTAAACGC
CACCTTGCAAATTGCC-1	TTACCCCTGG	TCGGCATGGACGAGCTGTACAAGTAAACGC
CTCGTCATCCCATTAT-1	TTACCCGCTT	TCGTCCATGCCGAGCTGTACAAGTAAACGC
TCATTTGGTTCGAATC-1	TTACCGGGGT	TCGGCATGGACGAGCTGTACAAGTAAACGC
AGGCCACGTCAACATC-1	TTACGATCTC	------------------------------
ATCATCTTCTCCAGGG-1	TTACGGATTT	TCGGCATGGACGAGCTGTACAAGTAAACGC
AGCATACTCGTAGGTT-1	TTACGGCATA	------------------------------
TGACAACAGGGTCGAT-1	TTACGGGGTG	TCGGCATGGACGAGCTGTACAAGTAAACGC
CATTCGCCAAGCGATG-1	TTACGGTATC	TCGGCATGGACGAGCTGTACAAGTAAACGC
CGAGAAGTCTGTCCGT-1	TTACGTCTGT	-----------GAGCTGTACAAGTAAACGC
CTTAACTCATCTCCCA-1	TTACGTTTAA	TCGGCATGGACGAGCTGTACAAGTAAACGC
GGACATTTCTAGCACA-1	TTACGTTTGA	TCGGCATGGACGAGCTGTACAAGTAAACGC
TTTGCGCGTTAGGGTG-1	TTACTACTAG	TCGGCATGGACGAGCTGTACAAGTAAACGC
CCGTGGAAGGGAGTAA-1	TTACTATTTA	TCGGCATGGACGAGCTGTACAAGTAAACGC
AAGGCAGCAACGATGG-1	TTACTGAAAC	TCGGCATGGACGAGCTGTACAAGTAAACGC
TATGCCCAGGGTATCG-1	TTACTGCGCC	TCGGCATGGACGAGCTGTACAAGTAAACGC
GTCACGGCATGCGCAC-1	TTACTTAATC	TCGGCATGGACGAGTTGTACAAGTAAACGC
GCTGGGTTCAACGGGA-1	TTACTTGTGG	TCGGCATGGACGAGCTGTACAAGTAAAGGC
CTCATTAAGGAATTAC-1	TTAGCATCTT	TCGGCATGGACG------------------
AATCGGTTCAAGGCTT-1	TTAGCGCACA	TCGGCATGGACGAGCTGTACAAGTAAACGC
AACTCCCGTAGCACGA-1	TTAGCTATTG	------------------------------
CTCACACGTACTTAGC-1	TTAGGAATAC	TCGGCATGGACGAGCTGTACAAGTAAACGC
AGGCCACGTCAACATC-1	TTAGGTTCCG	TCGGCATGGACGAGCTGTACAAGTAAACGC
TCGCGAGAGTGTCCAT-1	TTAGTTCAAT	------------------------------
TACCTTAAGATCCCAT-1	TTAGTTGTCC	------------------------------
CACCTTGTCGCTTAGA-1	TTATAATTAA	TCGGCATGGACGAGCTGTACAAGTAAACGC
GCACTCTGTGGACGAT-1	TTATATTCCT	------------------------------
TCTCATAGTATGAAAC-1	TTATCATAAG	TCGGCATGGACGAGCTGTACAAGTAAACGC
CGTGAGCAGTACGATA-1	TTATCCAAGC	TCGGCATGGACGAGCTGTACAAGTAAACGC
GAAGCAGCATCAGTAC-1	TTATCGTCTT	------------------------------
TACTCATAGCTGATAA-1	TTATGAATCT	------------------------------
GTTCTCGCACCCATTC-1	TTATGCTTGT	TCGGCATGGACGAGCTGTACAAGTAAACGC
CCTTACGTCGAGAACG-1	TTATGCTTTA	TCGGCATGGACGAGCTGTACAAGTAAACGC
TAGGCATCACGTCTCT-1	TTATGTTGTA	------------------------------
CTCGAGGTCGCCAGCA-1	TTATGTTTCA	TCGGCATGGACGAGCTGTACAAGTAAACGC
GATGCTAGTGTGAATA-1	TTATTAACGG	--GGCATGGACGAGCTGTACAAGTAAACGA
TCAGGATGTAGGGTAC-1	TTATTATAAC	TCGGCATGGACGAGCTGTACAAGTAAACGC
CGTCACTAGCTAGTTC-1	TTATTCCTGT	TCGGCATGGACGAGCTGTACAAGTAAACGC
CATCAGAGTTACGACT-1	TTATTCTAGC	------------------------------
TGAGGGAGTCCGTCAG-1	TTATTGTCTT	TCGGCATGGACGAGCTGTACAAGTAAACGC
CGATTGAAGATGTCGG-1	TTATTTGACG	TCGGCATGGACGAGCTGTACAAGTAAACGC
GTCCTCATCGGATGTT-1	TTATTTGCTG	TCGGCATGGACGAGCTGTACAAGTAAACGC
GCTCCTAAGAGTAATC-1	TTATTTGTTA	TCGGCATGGACGAGCTGTACAAGTAAACGC
ATTACTCAGAGGTAGA-1	TTCAAACAGG	TCGGCATGGACGAGCTGTACAAGTAAACGC
CTCGGAGGTAATTGGA-1	TTCAAAGCAT	TCGGCATGGACGAGCTGTACAAGTAAACGC
TGCTACCGTACCGGCT-1	TTCAACTGTT	TCGGCATGGACGAGCTGTACAAGTAAACGC
AGAGCGAGTCCAGTGC-1	TTCAATGTTT	TCGGCATGGACGAGCTGTACAAGTAAACGC
TGGTTCCCACACAGAG-1	TTCACATAGG	TCGGCATGGACGAGCTGTACAAGTAAACGC
GAATGAAGTACCGCTG-1	TTCACCGGCT	TCGGCATGGACGAGCTGTACAAGTAAACGC
CATCAGAAGACCTTTG-1	TTCACGCGAC	--------------CTGTACAAGTAAACGC
TATTACCGTCCGACGT-1	TTCACGGTTT	TCGGCATGGACGAGCTGTACAAGTAAACGC
CCCAATCGTCCATCCT-1	TTCACGTACT	TCGGCATGGACGAGCTGTACAAGTAAACGC
CACATAGAGATCTGAA-1	TTCACTTAAG	TCGGCATGGACGAGCTGTACAAGTAAACGC
AGGTCCGGTAGAAGGA-1	TTCAGACCTT	TCGGCATGGACGAGCTGTACAAGTAAACGC
CGGAGCTAGAGGTTAT-1	TTCAGCACTT	------------------------------
CAAGGCCGTATAGGGC-1	TTCAGTGCAG	TCGGCATGGACGAGCTGTACAAGTAAACGC
CCTACCAAGGCCCTCA-1	TTCAGTTCGC	TCGGCATGGACGAGCTGTACAAGTAAACGC
ATTATCCCACACGCTG-1	TTCATCTAGG	TCGGCATGGACGAGCTGTACAAGTAAACGC
ACGGAGATCAACCAAC-1	TTCATGATTG	------------------------------
ACTGAACGTGGAAAGA-1	TTCATGTTTT	TCGGCATGGACGAGCTGTACAAGTAAACGC
CTAGTGACATATACGC-1	TTCATTAATA	TCGGCATGGACGAGCTGTACAAGTAAACGC
ACGCCAGAGGCATGGT-1	TTCATTTCCC	-------------------------AACGC
CGAATGTTCCTTAATC-1	TTCCACTTTG	TCGGCATGGACGAAATGTACAAATAAACGC
GAAGCAGCATCAGTAC-1	TTCCAGCCGT	TCGGCATGGACGAGCTGTACAAGTAAACGC
GAAGCAGCATCAGTAC-1	TTCCAGCCGT	TCGGCATGGACGAGCTGTACAAGTAAACGC
TACCTTAAGATCCCAT-1	TTCCATCGTT	CCGGCATGGACGAGCTATACAAGTAAACGC
CTACGTCAGCTGCGAA-1	TTCCCTGGGT	TCGGCATGGACGAGCTGTACAAGTAAACGC
ACTTACTCACACAGAG-1	TTCCGACAGA	TCGGCATGGACGAGCTGTACAAGTAAACGC
TGCTACCGTACCGGCT-1	TTCCGCAAAG	------------------------------
TCCCGATCAGTCGATT-1	TTCCGGAACC	TCGGCATGGACGAGCTGTACAAGTAAACGC
GTCAAGTGTAAGGATT-1	TTCCTCTTGC	TCGGCATGGACGAGCTGTACAAGTAAACGC
TCGTACCCAGTTTACG-1	TTCCTGCTTT	TCGGCATGGACGAGCTGTACAAGTAAACGC
AGATCTGGTAGCCTCG-1	TTCGCATACG	---------------------------CGC
GATGCTATCGCCAAAT-1	TTCGCCTGAC	------------------ACAAGTAAACGC
GTCAAGTGTTAAGACA-1	TTCGCGCACC	TCGGCATGGACGAGCTGTACAAGTAAACGC
CCAATCCAGACCTAGG-1	TTCGCGCCAT	-------------GCTGTACAAGTAAACGC
ATTATCCGTCTGGAGA-1	TTCGGAATTT	TCGGCATGGACGAGCTGTACA---------
CATGGCGCAATAAGCA-1	TTCGGAGTCA	-----------GAGCTGTACAAGTAAACGC
ACTGCTCGTCAGAAGC-1	TTCGGCAGAT	------------------------------
GTGTTAGGTTCGTCTC-1	TTCGGGGTGT	------------------------------
CCACTACGTGCAACTT-1	TTCGTAATTG	TCGGCATGGACGAGCTGTACAAGTAAACGC
TGACAACAGGGTCGAT-1	TTCGTACACC	TCGGCATGGACGAGCTGTGCAAGTAAACGC
CATCCACCAGTCACTA-1	TTCGTATCAT	TCGGCATGGACGAGCTGTACAAGTAAACGC
GGCGACTTCTACTATC-1	TTCGTCGATA	TCGGCATGGACGAGCTGTACAAGTAAACGC
AGCTCTCGTTCGCGAC-1	TTCGTTCCGG	TCGGCATGGACGAGCTGTACAAGTAAACG-
ACGGAGATCTCAAACG-1	TTCTACCAAG	------------------------------
AAGGAGCTCACAACGT-1	TTCTATACTC	TCGGCATGGACGAGCTGTACAAGTAAACGC
GGCGTGTCACCGGAAA-1	TTCTATATGG	TCGGCATGGACGAGCTGTACAAGTAAACGC
CTGCTGTGTTAAAGAC-1	TTCTATGTTG	------------------------------
CGCCAAGGTGGCTCCA-1	TTCTCAGCAG	TCGGCATGGACGAACTGTACAAGTAAACGC
GTACTTTGTCCAAGTT-1	TTCTCATCGG	----------------GTACAAGTAAACGC
CATCAAGGTGCGATAG-1	TTCTCGGTGT	TCGGCATGGACGAGCTGTACAAGTAAACGC
GTGGGTCGTACAGTTC-1	TTCTCTAACT	TCGGCATGGACGAGCTGTACAAGTAAACGC
GAATAAGCAGATCGGA-1	TTCTCTCACA	------------------------------
TCACGAATCAGCCTAA-1	TTCTCTGAGA	----------------GTACAAGTAAACGC
CGGTTAATCATTGCCC-1	TTCTGATATT	TCGGCATGGACGAGCTGTACAAGTAAACGC
TGTCCCAAGCCGCCTA-1	TTCTGATTAT	TCGGCA------------------------
ACGGGCTTCAAAGACA-1	TTCTGCCATT	TCGGCATGGACGAGCTGTACAAGTAAACGC
TCAACGAAGTGGACGT-1	TTCTGTTAGG	TCGGCATGGACGAGCTGTACAAGTAAACGC
GCATGATTCTCTAGGA-1	TTCTGTTGTA	TCGGCATGGACGAGCTGTACAAGTAAACGC
CCGTGGACACTTCGAA-1	TTCTTATGCA	TCGGCATGGACGAGCTGTACAAGTAAACGC
CTACGTCAGTCTCGGC-1	TTCTTTCTTA	TCGGCATGGACGAGCTGTACAAGTAAACGC
GCGCCAACACGTGAGA-1	TTCTTTGTTA	TCGGCATGGACGAGCTGTACAAGTAAACGC
CGGCTAGAGCTGTTCA-1	TTGAAAAAGT	------------------------------
ACATACGAGTACTTGC-1	TTGAAAAGTC	TCGGCATGGACGAGCTGTACAAGTAAACGC
GGGATGATCATATCGG-1	TTGAAATATA	TCGGCATGGACGAGCTGTACAAGTAAACGC
GAATAAGGTACCGAGA-1	TTGAAGCATT	TCGGCATGGACGAGCTGTACAAGTAAACGC
CTACGTCGTCGAGATG-1	TTGACATAAA	TCGGCATGGACGAGCTGTACAAGTAAACGC
GATGAAAGTGAAATCA-1	TTGACGGGCA	------------------------------
GAAACTCCATGTTGAC-1	TTGAGTCGAG	TCGGCATGGACGAGCTGTACAAGTAAACGC
CTTAGGAAGCTCCTTC-1	TTGATTACGA	TCGGCATGGACGAGCTGTACAAGTAAACGC
TGGGAAGGTGGCTCCA-1	TTGATTATTC	TCGGCATGGACGAGCTGTACAAGTA-----
TGCGCAGTCTTGAGGT-1	TTGATTTTAT	-------GGACGAGCTGTACAAGTAAACGC
TGCGCAGTCTTGAGGT-1	TTGATTTTAT	TCGGCATGGACGAGCTGTACAAGTAAACGC
AAAGTAGAGCTACCTA-1	TTGCACTATG	------------------------------
CCGTACTGTAAAGGAG-1	TTGCATCAAC	TCGGCATGGACGAGCTGTACAAGTAAACGC
GGAGCAACACGAGAGT-1	TTGCCACCCA	---GCATGGACGAGCTGTACAAGTAAACGC
CTGAAACGTTTGACTG-1	TTGCCCGTAT	TCGGCATGGACGAGCTGTACAAGTAAACG-
AACTCAGCAACACGCC-1	TTGCCTATAC	TCGGCATGGACGAGCTGTACAAGTAAACGC
CACAGTAGTGTAACGG-1	TTGCGACCTA	TCGGCATGGACGAGCTGTACAAGTAAACGC
TGGTTCCCACACAGAG-1	TTGCTAGTTC	TCGGCATGGACGAGCTGTACAAGTAAACGC
ATAAGAGCATGGATGG-1	TTGCTATAGC	------------------------------
TCCCGATAGTGATCGG-1	TTGCTATTGA	TCGGCATGGACGAGCTGTACAAGTAAACGC
TTAGGACTCTTTACAC-1	TTGGACCCTA	TCGGCATGGACGAGCTGTACAAGTAAACGC
TCAGATGAGCTGATAA-1	TTGGACTATA	TCGGCATGGACGAGCTGTACAAGTAAACGC
CGATTGACATGTTGAC-1	TTGGAGCTGT	TCGGCATGGACGAGCTGTACAAGTAAACGC
CGCGGTACATGAAGTA-1	TTGGCCTCGC	TCGGCATGGACGAGCTGTACAAGTAAACGC
TTGTAGGAGATATGCA-1	TTGGCGCAAC	TCGGCATGGACGAGCTGTACAAGTAAACGC
TGTTCCGCAAATCCGT-1	TTGGGAATCT	TCGGCATGGACGAGCTGTACAAGTAAACGC
CGTTCTGCAAGGACAC-1	TTGGGGGCAT	TCGGCATGGACGAGCTGTACAAGTAAACGC
TCAGGATCAAACGTGG-1	TTGGGTACTT	-----------------------TAAACGC
GCAATCACATTAACCG-1	TTGGTTGAAT	------------------------------
GTACTCCAGCCCAATT-1	TTGTAAATCG	TCGGCATGGACGAGCTGTACAAGTAAACGC
CCTAAAGTCATAAAGG-1	TTGTAATTGC	TCGGCATGGACGAGCTGTACAAGTAAACGC
TTAACTCCATTGCGGC-1	TTGTACAGAC	TCGGCATGGACGAGCTGTACAAGTAAACGC
CGATGTAAGATCCTGT-1	TTGTACTACA	TCGGCATGGACGAGCTGTACAAGTAAACGC
AGGGATGGTGTGACGA-1	TTGTAGGTTC	TCGGCATAGACGAGCTGTACAAGTAAACGC
ACCTTTAAGGGCACTA-1	TTGTCGTTAT	TCGGCATGGACGAGCTGTACAAGTAAACGC
CCCAATCGTCAGGACA-1	TTGTCTACTG	TCGGCATGGACGAGCTGTACAAGTAAACGC
TGGTTCCCACCAGTTA-1	TTGTGCTTAA	TCGGCATGGACGAGCTGTACAAGTAAACGC
GCTTCCATCTGGCGTG-1	TTGTGGATAT	TCGGCATGGACGAGCTGTACAAGTAAACGC
GACGGCTAGCTAACTC-1	TTGTGTGCAT	------------------------------
CAGCAGCAGGTTCCTA-1	TTTACACATT	------------------------------
GGTATTGCAAAGTCAA-1	TTTACAGCTA	------------------------------
AAGACCTGTTCCTCCA-1	TTTACCCAAC	TCGGCATGGACGAGCTGTACAAGTAAACGC
TTTGCGCTCGGCCGAT-1	TTTACGTTCT	TCGGCATGGACGAGCTGTACAAGTAAACGC
GCAGTTATCCCAGGTG-1	TTTAGCAGAC	TCGGCATGGACGAGCTGTACAAGTAAACGC
TTTGCGCTCGGCCGAT-1	TTTAGCTGAT	TCGGCATGGACGAGCTGTACAAGTAAACGC
ACAGCTAGTAGAAGGA-1	TTTAGGACCA	TCGGCATGGACGAGCTGTACAAGTAAACGC
CGGCTAGCAGGAATCG-1	TTTAGGTCAT	TCGGCATGGACGAGCTGTACAAGTAAACGC
ACTATCTTCATTGCCC-1	TTTAGTTGTT	TCGGCATGGACGAGCTGTACAAGTAAACGC
GACGCGTGTCGCTTCT-1	TTTATCGTGT	TCGGCATGGACGAGCTGTACAAGTAAACGC
CAAGATCAGACGCAAC-1	TTTATCTAAG	------------------------------
AAATGCCTCGGCCGAT-1	TTTATCTAGA	TCGGCATGGACGAGCTGTACAAGTAAACGC
AGCTCTCCAGACAGGT-1	TTTATTCAGT	------------------------------
GCAATCACATTAACCG-1	TTTATTGATT	------------------------------
TGTATTCGTGCACGAA-1	TTTATTTATC	TCGGCATGGACGAGCTGTACAAGTAAACGC
TGGTTAGCAGTGGAGT-1	TTTCAAAACA	---GCATGGACGAGCTGTACAAGTAAACGC
GAATGAACAGTACACT-1	TTTCAAAGAA	------------------------------
TGTGTTTTCCTAGAAC-1	TTTCAAAGGT	TCGGCATGGACGAGCTGTACAAGTAAACGC
CTACACCTCAGTTAGC-1	TTTCAATCGA	TCGGCATGGACGAGCTGTACAAGTAAACGC
CACATTTTCGCCGTGA-1	TTTCACGATA	TCGGCATGGACGAGCTGTACAAGTAAACGC
ATAGACCGTTACTGAC-1	TTTCACTTTT	TCGGCATGGACGAGCTGTACA---------
CAGCTGGGTTAAAGAC-1	TTTCAGTGCA	TCGGCATGGACGAGCTGTACAAGTAAACGC
CGTTAGATCTGCAAGT-1	TTTCATTCCG	------------------------------
GGACAGAAGGCACATG-1	TTTCCGATTT	------------------------------
CTTCTCTTCATAACCG-1	TTTCCGCAGC	TCGGCATGGACGAGCTGTACAAGTAAACGC
GTTCTCGTCCTAGAAC-1	TTTCGGAAGC	TCGGCATGGACGAGCTGTACAAGTAAACGA
CATCAGAAGGGCTTGA-1	TTTCGGATTT	------------------------------
AGACGTTGTGTGCGTC-1	TTTCGGCTAT	TCGGCATGGACGAGCTGTACAAGTAAACGC
TGATTTCCAGGGATTG-1	TTTCGTACGT	TCGGCATGGACGAGCTGTACAAGTAAACGC
CCGTGGACATATGAGA-1	TTTCGTATTT	TCGGCATGGACGAGCTGTACAAGTAAACGC
ACCGTAATCATGTAGC-1	TTTCGTTGAT	TCGGCATGGACGAGCTGTACAAGTAAACGC
GCGAGAAGTACTCTCC-1	TTTCTAATGA	------------------------------
CTCGAGGGTCGTCTTC-1	TTTCTAGACA	TCTACATGGACGAGCTGTATAAGTAAACGT
CTCGAGGCAGGTCCAC-1	TTTCTATCGC	TCGGCATGGACGAGCTGTACAAGTAAACGC
GCTTGAATCATCATTC-1	TTTCTCAAGT	-------------------CAAGTAAACGC
CCAATCCAGCTGCCCA-1	TTTCTGCAAA	TCGGCATGGACGAGCTGTACAAGTAAACGC
CTCGTACAGGCAATTA-1	TTTCTGGTTA	TCGGCATGGACGAGCTGTACAAGTAAACGC
AGGGTGACACCTCGGA-1	TTTCTGTATG	GCGGCATGGACGAGCTGTAAAAGTAAACGC
CTCATTAAGTGGACGT-1	TTTCTTCGAC	TCGGCATGGACGAGCTGTACAAGTAAACGC
CTAGCCTGTGCCTGTG-1	TTTGACATTT	TCGGCATGGACGAGCTGTACAAGTAAACGC
TGTGTTTAGACAGGCT-1	TTTGAGATAA	TCGGCATGGACGAGCTGTACAAGTAAACGC
TACGGTAAGGGAGTAA-1	TTTGAGTGAA	TCGGCATGGACGAGCTGTACAAGTAAACGC
CGAGAAGAGATCTGAA-1	TTTGATGGTG	TCGGCATGGACGAGCTGTACAAGTAAACGC
ACCCACTGTTACTGAC-1	TTTGCAGAAA	TCGGCATGGACGAGCTGTACAAGTAAACGC
GGACAAGTCATACGGT-1	TTTGCATTAG	TCGGCATGGACGAGCTGTACAAGTAAACGC
CTCGAGGTCAAGATCC-1	TTTGCTCCAG	------------------------------
CCGGTAGAGCATCATC-1	TTTGGAATTT	TCGGCATGGACGAGCTGTACAAGTAAACGC
AGGGATGTCACTGGGC-1	TTTGGATATT	TCGGCATGGACGAGCTGTACAAGTAAACGC
GTTACAGAGTTGAGTA-1	TTTGGTCTGT	TCGGCATGGACGAGCTGTACAAGTAAACGC
CATATGGAGCTAAGAT-1	TTTGGTGTTA	TCGGCATGGACGAGCTGTACAAGTAAACGC
TCAGCTCAGATCCCAT-1	TTTGGTTAAC	TCGGCATGGACGAGCTGTACAAGTAAACGC
AGCATACTCGTAGGTT-1	TTTGGTTGAA	TCGGCATGGACGAGCTGTACAAGTAAACGC
GCAGTTAGTTACGACT-1	TTTGTACCCA	TCGGCATGGACGAGCTGTACAAGTAAACGC
CCGTACTTCCAAACAC-1	TTTGTCTTTC	-CGGCAGGGACGAGCTGCACAAGTAAACGC
CAGAATCAGAACAACT-1	TTTGTCTTTT	TCGGCATGGACGAGCTGTACAAGTAAACGC
TTTGCGCAGATGTGGC-1	TTTGTTGAGC	TCGGCATGGACGAGCTGTACAAGTAAACGC
ATAACGCTCAATAAGG-1	TTTGTTTCAA	TCGGCATGGACGAGCTGTACAAGTAAACGC
TATGCCCAGGGTATCG-1	TTTGTTTGAG	TCGGCATGGACGTGCTGTACAAGTAAACGC
ACTTGTTAGCAGATCG-1	TTTTAATATT	TCGGCATGGACGAGCTGTACAAGTAAACGC
TGTATTCGTATATGAG-1	TTTTAATCTA	TCGGCATGGACGAGCT--------------
GCACATAGTCTTTCAT-1	TTTTCACTGG	------------------------------
ACGAGGATCGGATGTT-1	TTTTCAGATT	TCGGCATGGACGAGCTGTACAAGTAAACGC
GGACAAGCACGGCCAT-1	TTTTCAGTTC	------------------------------
CACACAAAGTCGATAA-1	TTTTCATGTT	TCGGCATGGACGAGCTGTACAAGTAAACGC
CCGGTAGTCATTATCC-1	TTTTCATTGT	------------------------------
GGTATTGCACCCATTC-1	TTTTCCATTT	TCGGCATGGACGAGCTGTACAAGTAAACGC
TAAGCGTTCGTACGGC-1	TTTTCGACGA	TAGGCATGGACAAACTGTACAAGTAAAAGC
TGGGAAGAGCGGATCA-1	TTTTCTAGAG	TCGGCATGGACGAGCTGTACAAGTAAACGC
CTGTGCTGTTCGTGAT-1	TTTTCTCCGT	TCGGCATGGACGAGCTGTACAAGTAAACGC
GCAGCCAAGTTGTAGA-1	TTTTCTGGTT	CCGGCATGGACGAGCTGTACAAGTAAACGC
TTAACTCCAAGTTGTC-1	TTTTGAATTG	------------------------------
ATAGACCGTTACTGAC-1	TTTTGAGCCG	------------------------------
TTATGCTGTTGAACTC-1	TTTTGCCCAA	------------------------AAACGC
CTACGTCAGTCTCGGC-1	TTTTGTTAGC	TCGGCATGGACGAGCTGTACAAGTAAACGC
TATCTCATCCACTCCA-1	TTTTGTTCGC	TCGGCATGGACGAGCTGTACAAGTAAACGC
TACAGTGTCGAGAACG-1	TTTTTAAAAA	TCGGCATGGACGAGCTGTACAAGTAAACGC
CTACCCATCGAGCCCA-1	TTTTTGAGTG	TCGGCATGGACGAGCTGTACAAGTAAACGC
GTACGTACAAGACGTG-1	TTTTTGATGC	TCGGCATGGACGAGCTGTACAAGTAAACGC
TGTGTTTTCTTGTTTG-1	TTTTTGGGCC	TCGGCATGGACGAGCTGTACAAGTAAACGC
CGTTAGATCTGCAAGT-1	TTTTTGGTTT	------------------------------
CTGTGCTTCTGGTATG-1	TTTTTTAAGG	-----------------------TAAACGC
CCACGGAAGCCCAATT-1	TTTTTTACTA	TCGGCATGGACGAGCTGTACAAGTAAACGC
CGAGCACTCGCTGATA-1	TTTTTTGCGC	TCGGCATGGACGAGCTGTACAAGTAAACGC
